border_size=1
usage=map

Wot, Wot, Wot, Wot, Wot, Wot, Wot, Wot, Wot, Wot, Wot, Wot, Wot, Wot, Wot, Wot, Wot, Wot, Wot, Wot, Wot, Wot, Wot, Wot, Wot, Wot, Wot, Wot, Wot, Wot, Wot, Wot, Wot, Wot, Wot, Wot, Wwt, Wwt, Wwt, Ww, Gs, Gs, Gs^Ftp, Gs, Gs, Gs
Wot, Wot, Wot, Wot, Wot, Wot, Wot, Wot, Wot, Wot, Wot, Wot, Wot, Wot, Wot, Wot, Wot, Wot, Wot, Wot, Wot, Wot, Wwt, Wot, Wot, Wot, Wot, Wot, Wot, Wot, Wot, Wot, Wot, Wot, Wot, Wot, Wwt, Wwt, Ww, Ww, Gs, Gs^Ftp, Gs, Gs, Ss, Gs
Wot, Wot, Wot, Wot, Wot, Wot, Wot, Wot, Wot, Wot, Wot, Wot, Wot, Wot, Wot, Wot, Wot, Wot, Wot, Wot, Wwt, Wwrt, Wwrt, Wwt, Wot, Wot, Wot, Wot, Wot, Wot, Wot, Wot, Wot, Wot, Wwt, Wwt, Wwt, Wwt, Ww, Gs, Gs, Gs, Gs, Gs, Ss, Ss
Wot, Wot, Wot, Wot, Wwrt, Wwrt, Wot, Wot, Wot, Wot, Wot, Wot, Wot, Wot, Wot, Wot, Wot, Wot, Wot, Wot, Wot, Wwt, Wot, Wot, Wot, Wot, Wot, Wot, Wot, Wot, Wwt, Wot, Wwt, Wot, Wwt, Wwt, Wwt, Ww, Gs, Gs, Gs, Ss, Ss, Ss, Ss, Ss
Wot, Wot, Wot, Wwrt, Wwrt, Wot, Wot, Wot, Wot, Wot, Wot, Wot, Wot, Wot, Wot, Wot, Wot, Wot, Wot, Wot, Wot, Wot, Wot, Wot, Wot, Wot, Wot, Wot, Wot, Wot, Wwt, Wwt, Wwt, Wwt, Wwt, Wwt, Ww, Ww, Gs, Gs, Ss, Ss, Ss, Ss, Ss, Ss
Wot, Wot, Wot, Wot, Wot, Wot, Wot, Wot, Wot, Wot, Wot, Wot, Wot, Wot, Wot, Wot, Wot, Wot, Wot, Wot, Wot, Wot, Wot, Wot, Wot, Wwt, Wwt, Wwt, Wwt, Wwt, Wwt, Wwt, Wwt, Wwt, Wwt, Ww, Ww, Gs, Gs, Gs, Gs, Ss, Ss, Ss, Ss, Ss
Wot, Wot, Wot, Wot, Wot, Wot, Wot, Wot, Wot, Wot, Wot, Wot, Wot, Wot, Wot, Wot, Wot, Wot, Wwt, Wot, Wwt, Wwt, Wwt, Wot, Wwt, Wwt, Wwt, Wwt, Wwt, Wwt, Wwt, Wwt, Ww, Ww, Ww, Ww, Ww, Ww, Ww^Bw/, Gs, Gs, Ss, Ss, Ss, Ss, Ss
Wot, Wot, Wot, Wot, Wot, Wot, Wot, Wot, Wot, Wot, Wot, Wot, Wot, Wot, Wot, Wot, Wwt, Wot, Wwt, Wwt, Wwrt, Wwrt, Wwt, Wwt, Wwt, Wwt, Wwt, Wwt, Wwt, Wwt, Wwt, Ww, Ww, Ww, Gs, Ww, Ww, Ww, Ww^Bw/, Gs, Gs, Gs, Gs, Gs, Gs, Gs
Wot, Wot, Wot, Wot, Wot, Wot, Wot, Wot, Wot, Wot, Wot, Wot, Wot, Wot, Wot, Wot, Wwt, Wwt, Wwt, Wwt, Wwt, Wwt, Wwt, Wwt, Wwt, Wwt, Wwt, Wwt, Ww, Wwt, Ww, Ww, Gs, Gs, Gs, Ww^Bw/, Ww, Ww, Ww, Gs, Ww, Gs, Gs, Gs, Gs, Gs
Wot, Wot, Wot, Wot, Wot, Wot, Wot, Wot, Wot, Wot, Wot, Wot, Wwt, Wot, Wwt, Wwt, Wwt, Wwt, Wwt, Wwt, Wwt, Wwt, Wwt, Wwt, Wwt, Wwt, Ww, Ww, Ww, Ww, Gs, Gs, Gs^Ftp, Gs^Ftp, Gs, Ww^Bw/, Ww^Bw/, Ww, Ww, Ww, Ww, Ww, Ww, Ww, Ww, Ww
Wot, Wot, Wot, Wot, Wot, Wot, Wot, Wot, Wot, Wot, Wot, Wwt, Wwrt, Wwt, Wwt, Wwt, Wwt, Wwt, Wwt, Wwt, Ww, Ww, Ww, Wwt, Ww, Ww, Gs, Gs, Gs, Gs, Gs, Gs^Ftp, Gs, Gs, Gs, Gs, Gs, Gs, Gs, Ss, Ss, Ww, Ss, Ww, Ss, Ww
Wot, Wot, Wot, Wot, Wot, Wot, Wot, Wot, Wot, Wot, Wwt, Wwt, Wwrt, Wwrt, Wwt, Wwt, Wwt, Wwt, Ww, Ww, Ww, Ww, Gs, Ww, Gs, Gs, Gs, Gs, Hh, Gs, Gs, Gs, Gs, Gs, Gll^Ftr, Gll^Ftr, Gs, Gs, Gll^Ftr, Gs, Gs, Gs, Gs, Ss, Ss, Ss
Wot, Wot, Wot, Wot, Wot, Wot, Wwt, Wwt, Wwt, Wwt, Wwt, Wwt, Wwt, Wwt, Wwt, Wwt, Ww, Ww, Ww, Ww, Gs, Gs, Gs^Vht, Gs, Gs, Hh, Hh^Fms, Hh^Fms, Hh, Hh, Gs, Gs, Gs, Gs, Gs, Gll^Ftr, Gs, Gs, Gs, Gll^Ftr, Gs, Gs, Gs, Gs, Gs, Gs
Wot, Wot, Wot, Wot, Wot, Wot, Wwt, Wwrt, Wwt, Wwt, Wwt, Wwt, Ww, Ww, Ww, Ww, Gs, Ww, Gs, Gs, Gs, Gs, Gs^Fms, Gs^Fds, Hh, Hh^Fms, Mm, Mm, Mm, Hh^Fms, Gs^Fms, Gs, Gll^Ftr, Gs, Gs, Gs, Gs, Gs, Gs, Gs, Gs, Gs, Gs, Gs, Gs, Gs
Wot, Wot, Wot, Wot, Wwt, Wwt, Wwt, Wwt, Wwt, Wwt, Ww, Ww, Ww, Ww, Gs, Gs, Gs, Gs, Gs, Hh, Hh^Fms, Hh^Fms, Hh^Fms, Hh^Fds, Hh^Fds, Hh, Mm, Mm, Mm, Hh^Fms, Gs^Fms, Gs, Gll^Ftr, Gll^Ftr, Gll^Ftr, Gs, Gs, Gs, 1 Gs, 4 Gs, Gs, Gs, Gll^Ftr, Gll^Ftr, Gll^Ftr, Gll^Ftr
Wot, Wot, Wot, Wot, Wwt, Wwt, Wwt, Wwt, Wwt, Ww, Ww, Ww, Gs, Gs, Gs, Gs, Gs, Gs, Hh, Hh, Mm, Hh^Fms, Mm, Hh^Fds, Hh, Hh^Fds, Hh, Hh, Hh, Hh, Hh, Gs, Gs, Gll^Ftr, Gll^Ftr, Gs, Gs, Gs, Gs, Gs, Gs, Gs, Gs, Gs, Gs, Gs
Wot, Wot, Wot, Wwt, Wwt, Wwt, Wwt, Wwt, Ww, Ww, Gs, Gs, Gs, Gs, Gs, Hh, Hh, Hh, Hh^Fms, Hh^Fms, Mm, Mm, Mm, Hh, Hh^Fds, Hh, Hh, Gs, Gs, Gs, Hh, Hh, Gs, Gll^Ftr, Gs, Gs, Gs, Gs, Gs, Gs, Gs, Gs, Gs, Gll^Ftr, Gll^Ftr, Gll^Ftr
Wot, Wot, Wwt, Wwt, Wwt, Wwt, Ww, Ww, Gs, Gs, Gs, Gs, Gs, Gs, Hh, Hh, Mm, Mm, Mm, Mm, Mm, Mm, Hh, Hh, Hh, Hh^Fds, Hh, Gs, Gs, Hh, Hh^Fms, Hh, Gs, Gll^Ftr, Gs, Gs, Ss, Ss, Gs, Gs, Gll^Ftr, Gll^Ftr, Gll^Ftr, Gll^Ftr, Gll^Ftr, Gll^Ftr
Wot, Wot, Wwt, Wwt, Wwt, Wwt, Ww, Gs, Gs^Vht, Gs, Gs^Fms, Gs, Hh, Hh, Mm, Hh^Fms, Mm, Mm, Xu, Xu, Xu, Xu, Uu, Hh, Hh, Mm, Hh, Hh^Fms, Gs, Hh, Hh^Fms, Gs^Fms, Gs, Gs, Gs, Gs, Gs, Gs, Gs, Gs, Gs, Gs, Gs, Gs, Gs, Gs
Wwt, Wwt, Wwt, Wwt, Ww, Ww, Gs, Gs, Gs, Gs^Fms, Hh^Fms, Hh^Fms, Hh^Fms, Hh^Fms, Mm, Mm, Xu, Xu, Uu, Uu, Uu, Xu, Uu, Uu, Xu, Mm, Hh^Fms, Hh, Hh^Fms, Hh, Gs^Fms, Gs^Fms, Gs, Gs, Gs, Gs, Gs, Gs^Vht, Gs, Gs, Ss, Ss, Gll^Ftr, Gs, Gll^Ftr, Ss
Wwt, Wwt, Ww, Ww, Gs, Gs, Gs^Ftp, Gs, Gs^Fms, Gs^Fms, Hh^Fms, Hh^Fms, Mm, Mm, Xu, Xu, Uu, Uu, Uu^Emf, Uu^Emf, Uu, Xu, Uu, Uu, Xu, Mm, Hh, Hh^Fms, Hh, Hh^Fms, Gs^Fms, Gs, Gll^Ftr, Gll^Ftr, Gs, Gs, Gll^Ftr, Gll^Ftr, Gs, Gs, Gs, Ss, Ss, Ss, Ss, Ss
Ww, Ww, Ww, Ww, Gs, Gs^Ftp, Gs, Gs, Hh, Hh^Fms, Mm, Mm, Xu, Xu, Uu, Uu, Uu, Uu^Emf, Uu, Uu^Emf, Uu, Xu, Uu, Uu, Xu, Mm, Mm, Hh, Hh^Fms, Hh^Fms, Gs^Fms, Gs, Gs, Gs, Hh, Gs, Gs, Gll^Ftr, Gs, Gs, Gs, Ss, Gs, Ss, Ss, Ss
Ww, Ww, Ww, Gs, Gs, Gs^Ftp, Gs, Gs, Hh^Fms, Mm, Mm, Xu, Uu, Uu, Uu, Uu^Emf, Uu^Emf, Uu, Xu, Uu, Uu, Xu, Uu, Uu, Xu, Mm, Hh, Hh, Gs^Fms, Gs^Fms, Gs, Gs, Gs, Gs, Hh, Gs, Gs, Gs, Gs, Gs, Gs, Gs, Ss, Ss, Ss, Ss
Ww, Ww, Gs, Gs, Gs^Ftp, Gs^Ftp, Hh, Hh, Mm, Mm, Xu, Xu, Uu, Uu^Emf, Uu^Emf, Uu, Uu^Emf, Uu, Xu, Uu, Uu, Xu, Uu, Uu, Xu, Mm, Hh, Gs^Fms, Hh, Gs, Gll^Ftr, Gll^Ftr, Gs, Hh, Hh, Hh, Gs, Gs, Gs, Gll^Ftr, Gll^Ftr, Gs, Gs, Gs, Gs, Ss
Ww, Ww, Gs, Gs, Gs, Gs, Gs^Fms, Mm, Xu, Xu, Uu, Uu, Uu^Emf, Uu, Uu^Emf, Uu^Emf, Uu^Emf, Uu, Xu, Uu, Uu, Xu, Uu, Uu, Xu, Mm, Mm, Hh, Hh, Gs, Gs, Gs, Gs, Gs, Gs, Hh, Gs, Gs, Gs, Gll^Ftr, Gll^Ftr, Gs, Gs, Gs, Ss, Ss
Ww, Gs, Gs, Gs, Hh^Fds, Hh, Hh, Mm, Xu, Uu, Uu^Emf, Uu^Emf, Uu, Uu, Uu, Uu^Emf, Uu, Uu, Xu, Uu, Uu, Xu, Uu, Uu, Xu, Mm, Hh, Hh, Gs, Gs, Gs, Gs, Gll^Ftr, Gs, Gs, Gs, Ss, Ss, Gs, Gs, Gll^Ftr, Gll^Ftr, Gs, Ss, Ss, Ss
Gs, Gs, Gs, Gs^Fds, Hh^Fds, Hh, Mm, Mm, Xu, Uu, Uu, Uu^Emf, Uu, 2 Uu, Uu, Uu, Uu^Emf, Uu, Xu, Uu, Uu, Xu, Uu, Uu, Xu, Mm, Hh^Fms, Gs^Fms, Gs, Gs, Gs, Gs, Gll^Ftr, Gll^Ftr, Gs, Gs, Ss, Ss, Ss, Gs, Gs, Gs, Gs, Gs, Ss, Ss
Gs, Gs, Gs^Ftp, Hh, Hh, Hh, Mm, Mm, Xu, Uu, Uu^Emf, Uu, Uu, Uu, Uu, Uu^Emf, Uu^Emf, Uu, Xu, Uu, Uu^Emf, Uu, Uu^Emf, Uu, Xu, Mm, Hh^Fms, Gs, Gll^Ftr, Gll^Ftr, Gs, Gs, Gs, Gll^Ftr, Gs, Gs, Gs, Gs, Gs, Gs, Gll^Ftr, Gs, Gs, Gs, Gs, Gs
Gs, Gs, Gs^Ftp, Gs, Hh, Hh, Hh, Mm, Xu, Uu, Uu^Emf, Uu^Emf, Uu^Emf, Uu^Emf, Uu^Emf, Uu^Emf, Uu^Emf, Uu, Xu, Uu, Uu^Emf, Uu^Emf, Uu, Uu, Xu, Mm, Hh^Fms, Hh, Gll^Ftr, Gs, Gs, Gs, Sm, Gs, Sm, Gs, Sm, Gs, Gs, Gs^Vht, Gs, Gll^Ftr, Gll^Ftr, Gs, Hh, Gs
Gs, Gs, Gs^Ftp, Gs^Ftp, Gs, Gs, Hh, Mm, Xu, Uu, Uu^Emf, Uu^Emf, Uu, Uu^Emf, Uu, Uu^Emf, Uu, Uu, Xu, Uu^Vu, Uu, Uu, Xu, Xu, Mm, Mm, Hh^Fms, Hh^Fms, Gs^Fms, Gs, Sm, Sm, Sm, Sm, Sm, Sm, Sm, Sm, Sm, Gs, Gs, Gll^Ftr, Gs, Gs, Hh, Hh
Gs, Gs, Gs, Gs^Ftp, Gs, Gs, Hh, Mm, Xu, Uu, Uu, Uu^Vu, Uu, Uu, Uu^Emf, Uu^Emf, Uu, Uu, Xu, Xu, Xu, Xu, Mm, Mm, Hh, Hh, Gs^Fms, Hh^Fms, Gs, Gs, Sm, Sm, Sm, Sm, Sm, Sm, Sm, Sm, Sm, Gs, Gs, Gs, Gs, Gs, Gs, Gs
Ww, Gs, Gs^Ftp, Gs, Gs, Gs^Vht, Hh^Fms, Mm, Xu, Uu, Uu, Uu^Emf, Uu^Emf, Uu, Uu, Uu, Xu, Xu, Mm, Mm, Mm, Mm, Hh, Hh, Gs, Hh, Gs, Gs^Fms, Gs, Sm, Sm, Sm, Sm, Sm, Sm, Sm, Sm, Sm, Sm, Sm, Gs, Gs, Gs, Gll^Ftr, Gll^Ftr, Gs
Wwt, Gs, Gs^Ftp, Hh, Gs, Gs, Hh, Mm, Mm, Xu, Xu, Uu, Uu, Uu, Uu, Uu, Mm, Mm, Mm, Hh, Hh, Hh, Gs, Gll^Ftr, Ss, Gs, Gs, Gs, Gs, Gs, Sm, Sm, Sm, Sm, Sm, 3 Sm, Sm, Sm, Sm, Sm, Sm, Gs, Gs, Gll^Ftr, Gs, Gs
Wwt, Gs, Gs, Hh, Gs, Gs^Fms, Gs^Fms, Hh^Fds, Hh^Fds, Mm, Mm, Xu, Xu, Xu, Mm, Hh, Hh^Fms, Hh, Hh^Fms, Gs^Fms, Gs^Fms, Hh, Gs, Ss, Gs, Gs, Gs, Gll^Ftr, Gs, Gs, Gll^Ftr, Sm, Sm, Sm, Sm, Sm, Sm, Sm, Sm, Sm, Gll^Ftr, Gs, Gs, Gs, Hh^Fms, Hh
Wwt, Wwt, Gs, Gs^Ftp, Hh, Gs, Gs^Fms, Hh^Fms, Hh, Hh^Fds, Hh^Fds, Mm, Mm, Mm, Hh^Fms, Hh^Fms, Hh^Fms, Hh^Fms, Gs^Fms, Hh, Gs, Gs, Gs^Fms, Gs, Hh, Hh, Gs, Gs, Gs, Gs, Gs, Sm, Sm, Sm, Sm, Sm, Sm, Sm, Sm, Sm, Sm, Gs, Gs, Gs^Fms, Hh^Fms, Hh^Fms
Wwt, Ww, Gs, Gs, Gs^Ftp, Gs, Gs, Gs, Gs, Hh, Gs^Fds, Hh^Fds, Hh^Fds, Hh^Fms, Gs^Fms, Hh^Fms, Gs^Fms, Gs^Fms, Gs^Fds, Gs^Fds, Gs, Gs, Gs^Fms, Gs, Gs, Hh, Gs, Gs, Ss, Gs, Gs, Gs, Gs, Gll^Ftr, Gll^Ftr, Sm, Sm, Sm, Sm, Sm, Gll^Ftr, Gs, Gs^Vht, Gs, Hh, Hh
Wwt, Ww, Ww, Gs, Gs^Ftp, Hh, Gs, Gs^Fms, Gs, Hh^Fms, Gs^Fms, Gs^Fds, Gs^Fds, Gs^Fms, Gs^Fms, Gs^Fms, Gs^Fms, Gs, Gs, Gs, Gs^Vht, Gs^Fms, Gs^Fms, Gs^Fms, Gs, Gs, Gs, Ss, Ss, Ss, Gs, Gs, Gll^Ftr, Gs, Gs, Sm, Sm, Sm, Sm, Sm, Sm, Gs, Gs, Gs, Gll^Ftr, Hh
Wwt, Ww, Ww, Gs, Gs, Hh, Gs, Gs^Fms, Hh, Gs, Gs, Gs^Fms, Gs, Gs^Fms, Gs, Gs^Fms, Gs, Gs, Hh, Hh^Fms, Hh^Fms, Gs^Fms, Gs^Fms, Gs^Fms, Gs^Fms, Gs, Gs, Ss, Gs, Gs, Gs, Gs, Gs, Gs, Gll^Ftr, Gll^Ftr, Sm, Sm, Sm, Sm, Sm, Gll^Ftr, Gs, Gs, Gs, Hh
Wwt, Ww, Ww, Gs, Gs, Gs^Ftp, Gs, Gs^Fms, Hh, Hh^Fms, Gs, Gs, Gs^Fms, Gs, Gs^Fms, Gs, Gs^Fms, Hh^Fms, Hh, Hh^Fms, Hh^Fms, Gs^Fms, Gs^Fms, Gs^Fms, Gs, Gs, Gs^Fms, Gs, Gs, Gs, Gs^Fms, Gs^Fms, Gs^Fms, Gs, Gs, Gll^Ftr, Gll^Ftr, Sm, Sm, Sm, Sm, Gll^Ftr, Gll^Ftr, Gs, Gll^Ftr, Gs
Wwt, Ww, Ww, Ww, Gs, Gs^Ftp, Gs, Gs^Fms, Hh, Hh^Fms, Gs, Gs^Fms, Gs^Fms, Gs^Fms, Gs^Fms, Gs^Fms, Gs^Fms, Hh^Fms, Hh, Hh^Fms, Hh^Fms, Gs^Fms, Gs^Fms, Gs^Fms, Gs, Gs^Fms, Gs^Fms, Gs^Fms, Gs, Gs, Gs, Gs^Fms, Gs, Gs, Gs, Gll^Ftr, Gll^Ftr, Gll^Ftr, Sm, Sm, Sm, Gll^Ftr, Gll^Ftr, Gll^Ftr, Gll^Ftr, Gll^Ftr
