Wot, Wot, Wot, Wot, Wot, Wot, Wot, Wot, Wot, Wot, Wot, Wot, Wot, Wot, Wot, Wot, Wot, Wot, Wot, Wot, Wot, Wot, Wot, Wot, Wot, Wot, Wot, Wot, Wot, Wot, Wot, Wot, Wot, Wot, Wot, Wot, Wwt, Wwt, Wwt, Ww, Ds, Gg, Gg^Ftr, Gg, Gs, Gs
Wot, Wot, Wot, Wot, Wot, Wot, Wot, Wot, Wot, Wot, Wot, Wot, Wot, Wot, Wot, Wot, Wot, Wot, Wot, Wot, Wot, Wot, Wwt, Wot, Wot, Wot, Wot, Wot, Wot, Wot, Wot, Wot, Wot, Wot, Wot, Wot, Wwt, Wwt, Ww, Ww, Ds, Gg^Ftr, Gg, Gg, Ss^Qhu, Gs
Wot, Wot, Wot, Wot, Wot, Wot, Wot, Wot, Wot, Wot, Wot, Wot, Wot, Wot, Wot, Wot, Wot, Wot, Wot, Wot, Wwt, Wwrt, Wwrt, Wwt, Wot, Wot, Wot, Wot, Wot, Wot, Wot, Wot, Wot, Wot, Wwt, Wwt, Wwt, Wwt, Ww, Ds, Gg, Gg, Gs, Gs, Ss^Qhu, Ss^Qhu
Wot, Wot, Wot, Wot, Wwrt, Wwrt, Wot, Wot, Wot, Wot, Wot, Wot, Wot, Wot, Wot, Wot, Wot, Wot, Wot, Wot, Wot, Wwt, Wot, Wot, Wot, Wot, Wot, Wot, Wot, Wot, Wwt, Wot, Wwt, Wot, Wwt, Wwt, Wwt, Ww, Ds, Ds, Gg, Ss^Qhu, Ss^Qhu, Ss^Qhu, Ss^Qhu, Ss^Qhu
Wot, Wot, Wot, Wwrt, Wwrt, Wot, Wot, Wot, Wot, Wot, Wot, Wot, Wot, Wot, Wot, Wot, Wot, Wot, Wot, Wot, Wot, Wot, Wot, Wot, Wot, Wot, Wot, Wot, Wot, Wot, Wwt, Wwt, Wwt, Wwt, Wwt, Wwt, Ww, Ww, Ds, Gg, Ss^Qhu, Ss^Qhu, Ss^Qhu, Ss^Qhu, Ss^Qhu, Ss^Qhu
Wot, Wot, Wot, Wot, Wot, Wot, Wot, Wot, Wot, Wot, Wot, Wot, Wot, Wot, Wot, Wot, Wot, Wot, Wot, Wot, Wot, Wot, Wot, Wot, Wot, Wwt, Wwt, Wwt, Wwt, Wwt, Wwt, Wwt, Wwt, Wwt, Wwt, Ww, Ww, Ds, Re, Gg, Gg, Ss^Qhu, Ss^Qhu, Ss^Qhu, Ss^Qhu, Ss^Qhu
Wot, Wot, Wot, Wot, Wot, Wot, Wot, Wot, Wot, Wot, Wot, Wot, Wot, Wot, Wot, Wot, Wot, Wot, Wwt, Wot, Wwt, Wwt, Wwt, Wot, Wwt, Wwt, Wwt, Wwt, Wwt, Wwt, Wwt, Wwt, Ww, Ww, Ww, Ww, Ww, Ww, Ww^Bw/, Re, Gg, Ss^Qhu, Ss^Qhu, Ss^Qhu, Ss^Qhu, Ss^Qhu
Wot, Wot, Wot, Wot, Wot, Wot, Wot, Wot, Wot, Wot, Wot, Wot, Wot, Wot, Wot, Wot, Wwt, Wot, Wwt, Wwt, Wwrt, Wwrt, Wwt, Wwt, Wwt, Wwt, Wwt, Wwt, Wwt, Wwt, Wwt, Ww, Ww, Ww, Ds, Ww, Ww, Ww, Ww^Bw/, Re, Re, Gg, Re, Re, Re, Gg
Wot, Wot, Wot, Wot, Wot, Wot, Wot, Wot, Wot, Wot, Wot, Wot, Wot, Wot, Wot, Wot, Wwt, Wwt, Wwt, Wwt, Wwt, Wwt, Wwt, Wwt, Wwt, Wwt, Wwt, Wwt, Ww, Wwt, Ww, Ww, Ds, Ds, Re, Ww^Bw/, Ww, Ww, Ww, Ds, Ww, Re, Gg, Gg, Gg, Re
Wot, Wot, Wot, Wot, Wot, Wot, Wot, Wot, Wot, Wot, Wot, Wot, Wwt, Wot, Wwt, Wwt, Wwt, Wwt, Wwt, Wwt, Wwt, Wwt, Wwt, Wwt, Wwt, Wwt, Ww, Ww, Ww, Ww, Ds, Ds, Gs^Ftr, Gs^Ftr, Re, Ww^Bw/, Ww^Bw/, Ww, Ww, Ww, Ww, Ww^Bw|, Ww, Ww, Ww, Ww
Wot, Wot, Wot, Wot, Wot, Wot, Wot, Wot, Wot, Wot, Wot, Wwt, Wwrt, Wwt, Wwt, Wwt, Wwt, Wwt, Wwt, Wwt, Ww, Ww, Ww, Wwt, Ww, Ww, Ds, Ds, Ds, Ds, Gg, Gg^Ftr, Gg, Gg, Gg, Re, Re, Re, Re, Ss, Ss, Ww^Bw|, Ss, Ww, Ss, Ww
Wot, Wot, Wot, Wot, Wot, Wot, Wot, Wot, Wot, Wot, Wwt, Wwt, Wwrt, Wwrt, Wwt, Wwt, Wwt, Wwt, Ww, Ww, Ww, Ww, Ds, Ww, Ds, Ds, Gg, Gg, Hh, Gg, Gg, Gg, Gg, Gg, Gg^Ftr, Gg^Ftr, Gg, Gg, Gg^Ftr, Re, Re, Re, Gg, Ss, Ss, Ss
Wot, Wot, Wot, Wot, Wot, Wot, Wwt, Wwt, Wwt, Wwt, Wwt, Wwt, Wwt, Wwt, Wwt, Wwt, Ww, Ww, Ww, Ww, Ds, Ds, Gg, Ds, Gg, Hh, Hh^Ftr, Hh^Ftr, Hh, Hh, Gs, Gs, Gs, Gg, Gg, Gg^Ftr, Gg, Gg, Gg, Gg^Ftr, Gg, Re, Gg, Gg, Gg, Gg
Wot, Wot, Wot, Wot, Wot, Wot, Wwt, Wwrt, Wwt, Wwt, Wwt, Wwt, Ww, Ww, Ww, Ww, Ds, Ww, Ds, Ds, Gg, Gg, Gs^Ftr, Gs^Ftr, Hh, Hh^Ftr, Mm, Mm, Mm, Hh^Ftr, Gs^Ftr, Gs, Gll^Ftr, Gs, Gs, Gg, Gs, Gs, Gs, Gg, Re, Re, Gs, Gg, Gs, Gs
Wot, Wot, Wot, Wot, Wwt, Wwt, Wwt, Wwt, Wwt, Wwt, Ww, Ww, Ww, Ww, Ds, Ds, Gg, Ds, Gg, Hh, Hh^Ftr, Hh^Ftr, Hh^Ftr, Hh^Ftr, Hh^Ftr, Hh, Mm, Mm, Mm, Hh^Ftr, Gs^Ftr, Gs, Gll^Ftr, Gll^Ftr, Gll^Ftr, Gs, Gs, Gs, 1 Gs, 4 Gs, Gs, Gs, Gll^Ftr, Gll^Ftr, Gll^Ftr, Gll^Ftr
Wot, Wot, Wot, Wot, Wwt, Wwt, Wwt, Wwt, Wwt, Ww, Ww, Ww, Ds, Ds, Gg, Gg, Gs, Gg, Hh, Hh, Mm, Hh^Ftr, Mm, Hh^Ftr, Hh, Hh^Ftr, Hh, Hh, Hh, Hh, Hh, Gs, Gs, Gll^Ftr, Gll^Ftr, Gs, Gs, Gs, Gs, Gs, Gs, Gs, Gs, Gs, Gs, Gs
Wot, Wot, Wot, Wwt, Wwt, Wwt, Wwt, Wwt, Ww, Ww, Ds, Ds, Gg, Gg, Gs, Hh, Hh, Hh, Hh^Ftr, Hh^Ftr, Mm, Mm, Mm, Hh, Hh^Ftr, Hh, Hh, Gs, Gd, Gs, Hh, Hh, Gs, Gll^Ftr, Gs, Gs, Gd, Gs, Gs, Gs, Gs, Gs, Gs, Gll^Ftr, Gll^Ftr, Gll^Ftr
Wot, Wot, Wwt, Wwt, Wwt, Wwt, Ww, Ww, Ds, Ds, Gg, Gg, Gs, Gg, Hh, Hh, Mm, Mm, Mm, Mm, Mm, Mm, Hh, Hh, Hh, Hh^Ftr, Hh, Gs, Gd, Hh, Hh^Fms, Hh, Gs, Gll^Ftr, Gs, Gs, Ss^Qhu, Ss^Qhu, Gs, Gs, Gll^Ftr, Gll^Ftr, Gll^Ftr, Gll^Ftr, Gll^Ftr, Gll^Ftr
Wot, Wot, Wwt, Wwt, Wwt, Wwt, Ww, Ds, Gg, Gg, Gs^Ftr, Gs, Hh, Hh, Mm, Hh^Ftr, Mm, Mm, Xu^Qhh, Xu^Qhh, Xu^Qhh, Xu^Qhu, Uu^Qhu, Hh, Hh, Mm, Hh, Hh^Ftr, Gs, Hh, Hh^Fms, Gs^Ftr, Gs, Gs, Gs, Gs, Gs, Gd, Gs, Gs, Gs, Gs, Gs, Gs, Gs, Gs
Wwt, Wwt, Wwt, Wwt, Ww, Ww, Ds, Ds, Gg, Gs^Ftr, Hh^Ftr, Hh^Ftr, Hh^Ftr, Hh^Ftr, Mm, Mm, Xu^Qhh, Xu^Qhh, Uu, Uu, Uu, Xu^Qhh, Uu, Uu^Qhu, Xu^Qhu, Mm, Hh^Ftr, Hh, Hh^Ftr, Hh, Gs^Ftr, Gs^Ftr, Gs, Gs, Gs, Gs, Gs, Gs^Vht, Gs, Gs, Ss^Qhu, Ss^Qhu, Gll^Ftr, Gs, Gll^Ftr, Ss^Qhu
Wwt, Wwt, Ww, Ww, Ds, Ds, Gg^Ftr, Gg, Gs^Ftr, Gs^Ftr, Hh^Ftr, Hh^Ftr, Mm, Mm, Xu^Qhh, Xu^Qhh, Uu, Uu, Uu^Emf, Uu^Emf, Uu, Xu^Qhh, Uu, Uu, Xu^Qhu, Mm, Hh, Hh^Ftr, Hh, Hh^Ftr, Gs^Ftr, Gs, Gll^Ftr, Gll^Ftr, Gs, Gs, Gll^Ftr, Gll^Ftr, Gs, Gs, Gs, Ss^Qhu, Ss^Qhu, Ss^Qhu, Ss^Qhu, Ss^Qhu
Ww, Ww, Ww, Ww, Ds, Gg^Ftr, Gs, Gs, Hh, Hh^Ftr, Mm, Mm, Xu^Qhu, Xu^Qhh, Uu^Qhh, Uu, Uu, Uu^Emf, Uu^_mh, Uu^Emf, Uu^Qhh, Xu^Qhh, Uu, Uu, Xu^Qhu, Mm, Mm, Hh, Hh^Ftr, Hh^Ftr, Gs^Ftr, Gs, Gs, Gs, Hh, Gs, Gs, Gll^Ftr, Gs, Gs, Gs, Ss^Qhu, Gs^Vhs, Ss^Qhu, Ss^Qhu, Ss^Qhu
Ww, Ww, Ww, Ds, Gg, Gg^Ftr, Gs, Gs, Hh^Ftr, Mm, Mm, Xu^Qhu, Uu, Uu, Uu^Qhh, Uu^Emf, Uu^Emf, Uu, Xu^Qhh, Uu^Qhh, Uu^Qhh, Xu^Qhh, Uu^_ml, Uu, Xu^Qhu, Mm, Hh, Hh, Gs^Ftr, Gs^Ftr, Gs, Gs, Gs, Gd, Hh^Vht, Gd, Gd, Gs, Gs, Gs, Gs, Gs, Ss^Qhu, Ss^Qhu, Ss^Qhu, Ss^Qhu
Ww, Ww, Ds, Ds, Gg^Ftr, Gs^Ftr, Hh, Hh, Mm, Mm, Xu^Qhu, Xu^Qhu, Uu, Uu^Emf, Uu^Emf, Uu^Qhh, Uu^Qhh, Uu^Qhh, Xu^Qhu, Uu, Uu, Xu^Qhh, Uu, Uu, Xu^Qhu, Mm, Hh, Gs^Ftr, Hh, Gd, Gll^Ftr, Gll^Ftr, Gs, Hh, Hh, Hh, Gd, Gs, Gs, Gll^Ftr, Gll^Ftr, Gs, Gs, Gs, Gs, Ss^Qhu
Ww, Ww, Ds, Gg, Gs, Gs, Gs^Ftr, Mm, Xu^Qhu, Xu^Qhu, Uu, Uu, Uu^Emf, Uu, Uu^Emf, Uu^Emf, Uu^Emf, Uu, Xu^Qhu, Uu, Uu, Xu^Qhu, Uu, Uu, Xu^Qhu, Mm, Mm, Hh, Hh, Gs, Gs, Gs, Gs, Gd, Gd, Hh, Gs, Gs, Gs, Gll^Ftr, Gll^Ftr, Gs, Gs, Gs, Ss^Qhu, Ss^Qhu
Ww, Ds, Gg, Gg, Hh^Ftr, Hh, Hh, Mm, Xu^Qhu, Uu, Uu^Emf, Uu^Emf, Uu, Uu, Uu, Uu^Emf, Uu, Uu, Xu^Qhu, Uu, Uu, Xu^Qhu, Uu, Uu, Xu^Qhu, Mm, Hh, Hh, Gd, Gs, Gs, Gs, Gll^Ftr, Gs, Gs, Gs, Ss^Qhu, Ss^Qhu, Gs, Gs, Gll^Ftr, Gll^Ftr, Gs, Ss^Qhu, Ss^Qhu, Ss^Qhu
Ds, Ds, Gg, Gs^Ftr, Hh^Ftr, Hh, Mm, Mm, Xu^Qhu, Uu, Uu, Uu^Emf, Uu, 2 Uu, Uu, Uu, Uu^Emf, Uu, Xu^Qhu, Uu, Uu^Qhh, Xu^Qhu, Uu, Uu, Xu^Qhu, Mm, Hh^Ftr, Gs^Ftr, Gs, Gs, Gs, Gs, Gll^Ftr, Gll^Ftr, Gs, Gs, Ss^Qhu, Ss^Qhu, Ss^Qhu, Gs, Gs, Gs, Gs, Gs, Ss^Qhu, Ss^Qhu
Ds, Gg, Gg^Ftr, Hh, Hh, Hh, Mm, Mm, Xu^Qhu, Uu, Uu^Emf, Uu, Uu, Uu, Uu, Uu^Emf, Uu^Emf, Uu, Xu^Qhh, Uu^Qhh, Uu^Emf, Uu^Qhh, Uu^Qhh, Uu, Xu^Qhu, Mm, Hh^Ftr, Gd, Gll^Ftr, Gll^Ftr, Gs, Gs, Gs, Gll^Ftr, Gs, Gs, Gs, Gs, Gs, Gs, Gll^Ftr, Gs, Gs, Gs, Gs, Gs
Ds, Gg, Gg^Ftr, Gs, Hh, Hh, Hh, Mm, Xu^Qhu, Uu, Uu^Emf, Uu^Emf, Uu^Emf, Uu^Emf, Uu^Emf, Uu^Emf, Uu^Emf, Uu, Xu^Qhh, Uu^_mh, Uu^Emf, Uu^Emf, Uu^Qhh, Uu, Xu^Qhu, Mm, Hh^Ftr, Hh, Gll^Ftr, Gs, Gs, Gs, Sm^Qhu, Gs, Sm^Qhu, Gs, Sm^Qhu, Gs, Gs, Gs^Vht, Gs, Gll^Ftr, Gll^Ftr, Gs, Hh, Gs
Ds, Gg, Gg^Ftr, Gs^Ftr, Gs, Gd, Hh, Mm, Xu^Qhu, Uu, Uu^Emf, Uu^Emf, Uu, Uu^Emf, Uu, Uu^Emf, Uu, Uu, Xu^Qhh, Uu^Vu, Uu^Qhh, Uu^Qhh, Xu^Qhu, Xu^Qhu, Mm, Mm, Hh^Ftr, Hh^Ftr, Gs^Fms, Gs, Sm^Qhu, Sm^Qhu, Sm, Sm^Qhu, Sm, Sm^Qhu, Sm, Sm^Qhu, Sm^Qhu, Gs, Gs, Gll^Ftr, Gs, Gs, Hh, Hh
Ds, Gg, Gg, Gs^Ftr, Gs, Gs, Hh, Mm, Xu^Qhu, Uu, Uu, Uu^Vu, Uu, Uu, Uu^Emf, Uu^Emf, Uu, Uu, Xu^Qhu, Xu^Qhh, Xu^Qhu, Xu^Qhu, Mm, Mm, Hh, Hh, Gs^Ftr, Hh^Ftr, Gs, Gs^Vhs, Sm^Qhu, Sm, Ss, Ss, Sm, Sm, Sm, Sm, Sm^Qhu, Gs, Gs, Gs, Gs, Gs, Gs, Gs
Ww, Ds, Gg^Ftr, Gs, Gs, Gs, Hh^Ftr, Mm, Xu^Qhu, Uu, Uu, Uu^Emf, Uu^Emf, Uu, Uu, Uu, Xu^Qhu, Xu^Qhu, Mm, Mm, Mm, Mm, Hh, Hh, Gs, Hh, Gs, Gs^Ftr, Gs, Sm^Qhu, Sm^Qhu, Ss, Sm, Sm, Sm, Sm, Sm, Ss, Ss, Sm^Qhu, Gs, Gs, Gs, Gll^Ftr, Gll^Ftr, Gs
Wwt, Ds, Gg^Ftr, Hh, Gs, Gs, Hh, Mm, Mm, Xu^Qhu, Xu^Qhu, Uu, Uu, Uu^_ml, Uu^Qhu, Uu^Qhu, Mm, Mm, Mm, Hh, Hh, Hh, Gs, Gll^Ftr, Ss^Qhu, Gs, Gs, Gs, Gs, Gs, Sm^Qhu, Sm, Sm, Sm, Sm, 3 Sm, Sm, Sm, Ss, Sm^Qhu, Sm^Qhu, Gs, Gs, Gll^Ftr, Gs, Gs
Wwt, Ds, Ds, Hh, Gs, Gs^Ftr, Gs^Ftr, Hh^Ftr, Hh^Ftr, Mm, Mm, Xu^Qhu, Xu^Qhu, Xu^Qhu, Mm, Hh, Hh^Ftr, Hh, Hh^Ftr, Gs^Ftr, Gs^Ftr, Hh, Gs, Ss^Qhu, Gs, Gs, Gs, Gll^Ftr, Gs, Gs, Gll^Ftr, Sm^Qhu, Sm, Ss, Ss, Sm, Sm, Sm, Sm, Sm^Qhu, Gll^Ftr, Gs, Gs, Gs, Hh^Ftr, Hh
Wwt, Wwt, Ds, Gg^Ftr, Hh, Gs, Gs^Ftr, Hh^Ftr, Hh, Hh^Ftr, Hh^Ftr, Mm, Mm, Mm, Hh^Ftr, Hh^Ftr, Hh^Ftr, Hh^Ftr, Gs^Ftr, Hh, Gd, Gs, Gs^Ftr, Gs, Hh, Hh, Gd, Gs, Gs, Gs, Gs, Sm^Qhu, Sm^Qhu, Sm^Qhu, Sm^Qhu, Sm, Sm, Ss, Sm, Sm^Qhu, Sm^Qhu, Gs, Gs, Gs^Ftr, Hh^Ftr, Hh^Ftr
Wwt, Ww, Ds, Gg, Gg^Ftr, Gs, Gs, Gd, Gd, Hh, Gs^Ftr, Hh^Ftr, Hh^Ftr, Hh^Ftr, Gs^Ftr, Hh^Ftr, Gs^Ftr, Gs^Ftr, Gs^Ftr, Gs^Ftr, Gs, Gs, Gs^Ftr, Gd, Gs, Hh, Gs, Gs, Ss^Qhu, Gd, Gs, Gs, Gs, Gll^Ftr, Gll^Ftr, Sm^Qhu, Sm, Ss, Sm, Sm^Qhu, Gll^Ftr, Gs, Gs^Vht, Gd, Hh, Hh
Wwt, Ww, Ww, Ds, Gg^Ftr, Hh, Gs, Gs^Ftr, Gs, Hh^Ftr, Gs^Ftr, Gs^Ftr, Gs^Ftr, Gs^Ftr, Gs^Ftr, Gs^Ftr, Gs^Ftr, Gd, Gs, Gs, Gs^Vht, Gs^Ftr, Gs^Ftr, Gs^Ftr, Gs, Gs, Gs, Ss^Qhu, Ss^Qhu, Ss^Qhu, Gs, Gs, Gll^Ftr, Gs, Gs, Sm^Qhu, Sm^Qhu, Sm, Ss, Sm^Qhu, Sm^Qhu, Gs, Gs, Gs, Gll^Ftr, Hh
Wwt, Ww, Ww, Ds, Gg, Hh, Gs, Gs^Ftr, Hh, Gs, Gs, Gs^Ftr, Gs, Gs^Ftr, Gs, Gs^Ftr, Gs, Gs, Hh, Hh^Ftr, Hh^Ftr, Gs^Ftr, Gs^Ftr, Gs^Ftr, Gs^Ftr, Gs, Gs, Ss^Qhu, Gs, Gs, Gs, Gs, Gs, Gs, Gll^Ftr, Gll^Ftr, Sm^Qhu, Sm^_ml, Ss, Sm, Sm^Qhu, Gll^Ftr, Gs, Gs, Gs, Hh
Wwt, Ww, Ww, Ds, Ds, Gg^Ftr, Gg, Gs^Ftr, Hh, Hh^Ftr, Gs, Gs, Gs^Ftr, Gs, Gs^Ftr, Gs, Gs^Ftr, Hh^Ftr, Hh, Hh^Ftr, Hh^Ftr, Gs^Ftr, Gs^Ftr, Gs^Ftr, Gs, Gs, Gs^Ftr, Gs, Gs, Gs, Gs^Ftr, Gs^Ftr, Gs^Ftr, Gs, Gs, Gll^Ftr, Gll^Ftr, Sm^Qhu, Sm^Qhu, Sm, Sm^Qhu, Gll^Ftr, Gll^Ftr, Gs, Gll^Ftr, Gs
Wwt, Ww, Ww, Ww, Ds, Gg^Ftr, Gg, Gs^Ftr, Hh, Hh^Ftr, Gs, Gs^Ftr, Gs^Ftr, Gs^Ftr, Gs^Ftr, Gs^Ftr, Gs^Ftr, Hh^Ftr, Hh, Hh^Ftr, Hh^Ftr, Gs^Ftr, Gs^Ftr, Gs^Ftr, Gs, Gs^Ftr, Gs^Ftr, Gs^Ftr, Gs, Gs, Gs, Gs^Ftr, Gs, Gs, Gs, Gll^Ftr, Gll^Ftr, Gll^Ftr, Sm^Qhu, Sm^Qhu, Sm^Qhu, Gll^Ftr, Gll^Ftr, Gll^Ftr, Gll^Ftr, Gll^Ftr
