Ql, Ql, Ql, Xu, Uh, Uh, Uh, Xu, Xu, Xu, Xu, Xu, Xu, Xu, Xu, Xu, Xu, Xu, Xu, Xu, Xu, Xu, Xu, Xu, Xu, Xu, Xu, Xu, Xu, Xu, Xu, Xu, Xu, Xu, Xu, Xu, Xu, Xu, Xu, Xu, Xu, Xu
Ql, Ql, Ql, Ql, Uh, Uh, Uh, Uh, Uh, Xu, Uu, Xu, Uu, Xu, Xu, Xu, Xu, Xu, Xu, Xu, Xu, Xu, Xur, Xur, Xu, Xu, Uu, Xu, Xu, Xu, Uu, Xu, Uu, Xu, Xur, Xur, Uu, Xu, Xu, Xu, Xu, Xu
Ql, Ql, Ql, Ql, Ql, Uh, Ql, Uh, Uh, Xu, Xu, Uu, Xu, Uu^Edb, Uu^Em, Xu, Uu^Em, Uu, Uu^Em, Xu, Uu, Uu, Uu, Uu^Edb, Uu^Edb, Uu, Uu^Tf, Uu, Uu, Uu, Uu, Uu, Xu, Uu, Uu, Uu^Em, Uu^Edb, Uu^Vu, Xu, Xu, Uu, Xur
Ql, Ql, Ql, Ql, Ql, Ql, Ql, Uh, Uh, Uh, Xu, Xu, Uu^Edb, Xu, Uu^Em, Xu, Uu^Edb, Uu^Em, Uu, Uu, Xu, Uu, Uu, Uu^Vu, Uu, Xu, Xu, Xu, Xu, Xu, Xu, Xu, Xu, Xu, Xu, Uu^Em, Uu^Em, Xu, Xu, Xu, Uu, Xu
Ql, Ql, Mv, Ql, Ql, Ql, Ql, Ql, Uh, Uh, Xu, Uu, Uu^Em, Xuc, Xu, Xu, Xu, Uu, Xu, Xu, Xur, Xu, Xu, Uu, Xu, Xu, Uu, Uu, Uu, Uu, Uu, Uu, Uu, Uu, Uu, Uu, Xu, Xu, Xu, Uu^Edb, Uu, Xu
Ql, Mm, Mm, Mm, Ql, Ql, Ql, Ql, Uh, Uh, Xu, Xu, Uu, Xuc, Uu, Xu, Xu, Xu, Uu^Em, Uu, Uu, Uu, Uu, Xu, Uu, Uu, Xu, Uu^Tf, Xu, Xu, Xu, Xu, Xu, Xu, Xu, Xu, Xu, Xu, Uu, Uu^Edb, Xu, Xu
Ql, Ql, Ql, Ql, Ql, Ql, Ql, Ql, Uh, Uh, Uu^Em, Xu, Xu, Xu, Uu, Xu, Qxu^Bs\, Xu, Uu^Em, Xu, Uu, Uu, Xu, Uu, Xu, Uu, Uu, Xu, Xu, Xu, Xur, Xu, Uu, Uu, Uu^Em, Uu, Uu^Em, Xu, Xu, Uu^Edb, Uu^Em, Xu
Ql, Ql, Ql, Ql, Ql, Ql, Uh, Uh, Uh, Uh, Uu^Em, Xu, Uu^Tf, Uu, Uu^Vu, Xu, Uu, Uu, Xu, Xu, Xu, Uu, Xu, Xu, Uu^Vu, Xu, Xu, Uu, Uu^Em, Uu, Uu, Xur, Xu, Xu, Xu, Xu, Uu^Em, Uu, Uu, Xu, Uu, Xu
Ql, Ql, Ql, Ql, Uh, Ql, Uh, Uh, Xu, Uu^Edb, Xu, Xu, Xu, Xu, Uu, Uu^Em, Xu, Xu, Xu, Xu, Uu^Tf, Uu, Xu, Xu, Uu, Xu, Xu, Uu^Em, Uu, Uu^Em, Uu, Uu^Tf, Xu, Xu, Uu^Edb, Uu^Em, Xu, Uu^Tf, Uu, Xu, Uu^Em, Xu
Uh, Uh, Uh, Uh, Uh, Uh, Xu, Xu, Xu, Xu, Uu^Em, Uu^Vu, Xu, Xu, Uu, Xu, Xu, Xu, Xu, Xur, Uu^Em, Uu, Xu, Xu, Xu, Uu, Uu, Xu, Uu, Uu^Vu, Uu, Xu, Uu, Uu, Xu, Xu, Xu, Xu, Xu, Uu, Uu, Xu
Uh, Uh, Uh, Uh, Xu, Xu, Uu, Xu, Xu, Uu, Xu, Xu, Xu, Xu, Xu, Xu, Uu, Uu, Xu, Uu, Uu^Em, Uu, Xu, Xu, Xu, Xu, Uu, Xu, Xu, Uu, Xu, Xu, Uu, Xu, Xu, Xu, Uu, Xu, Xur, Uu, Uu, Xu
Xu, Xu, Xu, Xu, Xu, Uu, Uu^Em, Uu^Em, Uu^Edb, Xu, Uu, Uu, Uu, Uu, Uu, Qxu, Qxu, Uu, Xu, Xu, Xu, Xu, Xur, Uu^Vu, Uu, Xu, Xu, Xu, Uu, Xu, Uu, Uu, Uu, Xu, Xu, Uu, Uu^Edb, Uu, Xu, Uu, Uu, Xu
Xu, Xu, Xu, Xu, Xu, Uu, Uu, Uu, Xu, Uu, Xu, Xu, Xu, Uu, Qxu, Qxu^Bs\, Uu, Uu, Xu, Xu, Tb^Tf, Xur, Uu, Uu, Uu, Xu, Uu, Xu, Uu, Uu, Uu, Xur, Uu, Xu, Xu, Uu^Em, Uu, Uu, Xu, Xu, Uu, Xu
Xu, Xu, Xue, Qxu, Qxu, Xu, Xu, Xu, Uu^Edb, Xu, Uu, Xu, Uu, Uu, Qxu, Qxu, Uu, Xu, Uu^Em, Xu, Uu^Em, Uu, Uu, Xu, Tb^Tf, Uu, Xu, Uu, Xu, Xu, Xuc, Uu, Uu, Xu, Xu, Xu, Xu, Xu, Xu, Uu, Uu, Xu
Xu, Xue, Uue, Uue, Uu^Edb, Qxu, Qxu, Xu, Uu, Uu^Edb, Uu^Em, Uu, Uu, Uu, Uu, Qxu, Uu^Em, Xu, Uu, Uu^Em, Uu^Em, Uu^Es, Uu, Xu, Xu, Xu, Xur, Xur, Uu^Em, Xu, Uu, Xu, Xu, Uu, Uu^Vu, Xu, Xu, Xu, Uu, Uu, Xu, Xu
Xu, Xue, Uue, Uue^Emf, Xu, Qxu, Xue, Xue, Xue, Uu, Uu, Uu, Xu, Uu, Uu^Vu, Uu, Uu, Uu, Xu, Uu, Xu, Uu^Es, Uu^Es, Xu, Xu, Xur, Uu, Uu, Uu^Em, Uu, Uu^Es, Uu^Em, Uu^Edb, Xu, Xu, Xu, Xu, Xu, Uu, Uu, Xu, Xu
Xu, Xu, Xu, Uu, Xu, Xue, Uue, Uue, Uue, Xue, Xue, Xue, Xue, Uu^Em, Uu, Uu, Xu, Xu, Uu, Xu, Xu, Uu, Uu, Xu, Xu, Tb^Tf, Uu, Uu, Uu^Em, Uu^Em, Uu^Es, Uu, Uu, Uu, Uu, Xu, Uu, Uu, Xur, Xu, Xu, Xu
Xue, Xue, Xue, Xu, Xue, Xue, Uue, Uue^Edb, Uue^Em, Uue, Uue, Tb^Tf, Xue, Xue, Xue, Xu, Xu, Uu, Uu^Em, Uu^Es, Xu, Xu, Uu, Xu, Xu, Uu, Uu, Uu^Em, Uu^Em, Uu, Uu, Xur, Xu, Xu, Xu, Uu, Xu, Xu, Uu, Uu, Xu, Xu
Xue, Urb^Dr, Urb^Vud, Xue, Xue, Tb^Tf, Uue, Uue, Uue^Em, Dd^Es, Dd, Uue, Uue, Uue, Uue^Emf, Xue, Xue, Uu^Em, Uu, Uu^Es, Xu, Xu, Uu^Es, Xu, Xu, Uu, Uu, Uu^Em, Uu, Uu, Xu, Xu, Xu, Uu^Vu, Uu^Edb, Xu, Uu^Em, Uu^Em, Uu, Uu, Xu, Xu
Xue, Xue, Ur^Edb, Xue, Tb^Tf, Uue, Dd^Es, Dd, Dd, Dd, Ds, Dd, Dd^Es, Dd, Dd, Uue, Xue, Xu, Xue, Xu, Xu, Tb^Tf, Uu, Xu, Xu, Uu, Uu, Uu, Xuc, Xu, Mm, Mm, Mm, Xu, Xu, Uu^Em, Uu^Em, Uu^Em, Xu, Xu, Xu, Xu
Xue, Ur, Xue, Xue, Ur, Ur, Ds, Ds, Ds, Ds, Wwt, Ds, Ds, Ds^Es, Dd, Uue^Emf, Uue, Xue, Tb^Tf, Xue, Xu, Xu, Uu, Xu, Xu, Xu, Xu, Xu, Hh, Hh, Hh, Mm, Mm, Mm, Mm, Xu, Xu, Xu, Xu, Xu, Xu, Xu
Xue, Ur, Xue, Uue^Emf, Ur, Dd, Ds, Wwt, Wwt, Wwt, Wwt, Wwt, Ds, Ds, Ds, Dd, Dd^Es, Uue, Tb^Tf, Xue, Xu, Uu, Xur, Xu, Xu, Xu, Mm, Mm, Hh, 1 Hh, Hh, Mm, Mm, Mm, Mm, Mm, Mm, Mm, Mm, Mm, Mm, Mm
Xuc, Ur, Xuc, Ur, Dd^Es, Dd, Ds^Edb, Wwt, Wwt, Wwt, Wot, Wwt, Wwt, Wwt, Wwt, Ds^Edb, Dd, Uue, Uue, Xue, Xue, Uu, Xu, Uu, Xu, Xu, Mm, Mm, Hh^Fds, Hh, Hh, Hh^Fds, Mm, Mm, Mm, Mm, Mm, Mm, Hh^Fds, Hh^Fds, Hh^Fds, Hh^Fds
Uue, Ur^Edb, Ur, Ur, Dd, Ds, Wwt, Wwt, Wot, Wot, Wot, Wot, Wot, Wwt, Wwt, Ds, Dd, Uue, Uue^Vu, Tb^Tf, Xu, Xu, Uu, Uu, Xu, Xu, Mm, Mm, Hh, Hh, Hh^Do, Hh, Hh, Hh, Hh, Hh^Fds, Hh^Fds, Hh^Fds, Gs^Fds, Gs^Fds, Gs^Fds, Gs^Fds
Dd, Uue, Dd^Es, Dd, Ds, Ds, Wwt, Wwt, Wot, Wot, Wot, Wot, Wwt, Wwt, Ds, Ds^Es, Dd, Dd, Uue, Tb^Tf, Xu, Uu, Xu, Xu, Mm, Mm, Wwt, Wwt, Wwt, Hh, Hh, Hh, Hh^Fms, Hh, Gs, Hh^Fds, Gs^Fms, Hh^Fms, Gs, Gs, Gs, Gs
Ds, Dd^Es, Ds, Ds, Wwt, Wwt, Wwt, Wwt, Wot, Wot, Wot, Wwt, Wwt, Ds, Dd, Ds^Es, Dd, Uue, Xue, Xu, Uu, Uu, Xu, Xu, Mm, Mm, Hh, Hh, Hh^Fms, Wwt, Hh, Hh, Gs, Gs^Fms, Hh^Fms, Gs^Fms, Gs, Gs, Dd, Dd, Dd^Es, Dd
Wwt, Ds, Wwt, Ds, Wwt, Wwt, Wwt, Wot, Wwt, Wot, Wwt, Wwt, Ds, Ds, Uue^Tf, Dd, Uue, Uue, Xue, Uu, Xu, Xu, Mm, Mm, Hh^Fms, Hh^Fms, Hh, Hh^Fms, Gs, Wwt, Gs, Gs, Gs, Hh, Gs, Hh, Gs^Fms, Gd, Gd, Dd^Es, Dd^Es, Dd^Es
Ds, Wwt, Wwt, Wwt, Wwt, Wwt, Wwt, Wwt, Wwt, Wwt, Wwt, Wwt, Ds, Dd, Xue, Uue, Xue, Xue, Xu, Xu, Xu, Xu, Mm, Mm, Hh, Hh, Gs, Gs, Gs, Ww, Ww, Gs^Ftp, Ww, Gs, Wwt, Gs, Hh, Hhd, Hhd, Gd, Dd^Es, Dd
Dd, Ds, Ds, Wwt, Ds, Wwt, Ds, Wwt, Ds, Wwt, Ds, Ds, Dd^Es, Uue^Emf, Xue, Xue, Xu, Xu, Xu, Xu, Mm, Mm, Hh, Hh, Gs, Gs, Hh^Fms, Hh, Gs, Gs^Ftp, Ss, Wwt, Wwt, Wwt, Wwt, Gs, Gs, Hh, Hhd, Gd, Gd, Gd
Uue, Dd, Dd, Ds, Dd, Ds, Dd, Ds, Dd, Ds, Dd^Es, Dd^Edb, Uue, Uue, Xue, Xu, Mm, Mm, Mm, Mm, Hh^Fds, Hh^Fds, Gs^Ftp, Hh^Do, Gs, Hh, Gs, Gs^Fms, Gs, Gs, Gs, Gs, Gs, Gs, Gs^Ftp, Wwt, Wwt, Gs^Fds, Gs^Fds, Hhd, Hhd, Hhd
Xue, Uue, Uue, Uue^Emf, Uue^Vu, Uue, Uue^Em, Uue^Em, Uue, Uue^Emf, Uue, Uue, Xue, Xue, Xu, Xu, Mm, Wwt, Wwt, Hh^Ft, Gs^Ft, Hh^Fds, Hh^Fds, Gs, Hh^Ftp, Gs, Hh, Gs, Gs^Fms, Gs, Hh^Fms, Gs^Fms, Hh^Fms, Gs, Gs, Gs^Ftp, Wwt, Ss, Ss, Gs^Fds, Gs^Fds, Gs^Fds
Xue, Uue^Emf, Xue, Uue, Uue, Uue, Xue, Uue, Xue, Uue, Uue^Emf, Uue, Xue, Xue, Xue, Xu, Mm, Mm, Hh^Ft, Wwt, Gs^Ft, Gs^Ftp, Hh^Fds, Gs^Ftp, Gs^Ftp, Hh, Gs, Gs, Gs, Hh^Fms, Hh^Fms, Hh^Fms, Hh, Hh, Gs, Gs, Gs, Wwt, Wwt, Wwt, Wwt, Ss
Xue, Xue, Uue, Uue, Xue, Uue, Xue, Xue, Xue, Xue, Tb^Tf, Uue^Emf, Tb^Tf, Tb^Tf, Xue, Xu, Mm, Mm, Hh^Fds, Wwt, Wwt, Gs^Ft, Gs^Ftp, Gs^Ftp, Gs, Gs, Hh^Fds, Gs^Fds, Hh, Gs, Gs, Gs, Gs, Gs, Gs, Hh^Do, Hh, Gs, Ss, Ss, Ss, Wwt
Xue, Xue, Xue, Xue, Xue, Xue, Xue, Xue, Xue, Xue, Xue, Xue, Xue, Xue, Xu, Xu, Mm, Hh, Hh, Gs^Ft, Wwt, Gs^Ft, Gs, Hh^Ftp, Gs, Hh, Gs, Hh^Fds, Hh, Gs^Fds, Gs^Fds, Gs, Gs, Gs, Hh^Ftp, Hh^Ftp, Hh^Ftp, Gs, Gs, Gs, Gs, Ss
