border_size=1
usage=map

Hh^Fms, Gs, Gs, Gd, Gd, Gd, Hhd, Hhd, Hhd, Hhd, Md, Hhd, Hhd, Hhd, Hhd, Md, Md, Hhd, Hhd, Hhd, Md, Md, Hhd, Uh, Uh, Uh, Uh, Uh, Xu, Xu, Xu, Xu, Xu, Xu, Xu, Xu
Hh^Fms, Gs^Fds, Hh^Fds, Gs, Gs, Gd, Hhd, Hhd, Hhd, Hhd, Hhd, Hhd, Md, Hhd, Hhd, Md, Hhd^Fmf, Hhd^Fmf, Hhd^Fmf, Md, Md, Hhd, Uh, Uh, Uh, Uh, Uh, Uh, Uh, Uh, Uh, Uh, Uh, Xu, Xu, Xu
Mm, Hh^Vht, Mm, Hh^Fds, Gs^Fds, Gd, Gd, Hhd, Gd, Hhd, Hhd, Hhd, Hhd, Md, Hhd, Hhd, Md, Hhd^Fmf, Md, Md, Hhd, Hhd, Uh, Uh^Vd, Uh, Uh, Ql, Uh, Ql, Ql, Uh, Uh, Uh, Uh, Uh, Uh
Mm, Mm, Mm, Hh^Fms, Hh^Fds, Gs, Gs, Gd, Gd, Gd, Hhd, Hhd, Hhd, Md, Hhd, Md, Md, Hhd, Md, Md, Hhd, Uh, Ce, Uh, Uh, Ql, Ql, Ql, Ql, Ql, Ql, Ql, Uh, Uh, Uh, Uh
Mm, Mm, Mm, Hh^Fms, Hh^Fms, Gs^Fms, Gs^Fms, Gs, Gd, Gd, Hhd, Hhd^Vd, Hhd, Hhd, Hhd, Hhd, Hhd, Hhd, Md, Md, Hhd, Ce, 5 Ke, Ce, Uh, Ql, Ql, Ql, Ql, Ql, Ql, Ql, Ql, Ql, Ql, Ql
Mm, Mm, Mm, Mm, Mm, Hh^Fms, Gs^Fms, Gs, Gs, Gd, Gd, Hhd, Hhd, Hhd, Hhd, Md, Hhd, Md, Hhd, Md, Hhd, Ce, Ce, Ce, Uh, Uh, Ql, Ql, Ql, Ql, Ql, Ql, Ql, Ql, Ql, Ql
Mm, Mm, Mm, Mm, Hh, Hh^Fms, Hh^Fms, Gs^Fds, Gs, Gs, Gd, Hhd, Hhd, Hhd, Md, Hhd, Hhd, Hhd, Hhd, Md, Hhd, Uh, Uh, Uh, Uh, Ql, Ql, Ql, Ql, Ql, Ql, Ql, Ql, Ql, Ql, Ql
Mm, Mm, Mm, Mm, Mm, Mm, Mm, Hh^Fms, Gs^Fms, Gs, Gd, Hhd, Hhd^Fmf, Hhd^Fmf, Hhd^Fmf, Hhd, Md, Hhd, Md, Md, Md, Hhd, Ce, 1 Ke, Ce, Uh, Uh, Uh, Uh, Ql, Ql, Ql, Ql, Ql, Uh, Uh
Mm, Mm, Mm, Mm, Mm, Mm, Mm, Hh^Fms, Hh^Fms, Gs, Gd, Gd, Hhd, Hhd^Fmf, Hhd, Hhd, Hhd, Hhd, Hhd^Fmf, Hhd, Md, Hhd, Uh, Ce, Uh, Uh, Uh, Uh, Ql, Ql, Uh, Ql, Ql, Ql, Uh, Uh
Hh, Mm, Hh^Vc, Mm, Mm, Mm, Mm, Mm, Hh^Fms, Gs^Fds, Gs, Gd, Hhd, Md, Hhd, Hhd, Hhd, Hhd^Fmf, Hhd^Fmf, Hhd^Fmf, Hhd, Hhd, Hhd, Uh, Uh, Uh^Vd, Uh, Uh, Uh, Uh, Uh, Uh, Uh, Uh, Uh, Uh
Hh, Hh, Hh, Hh, Hh, Mm, Hh, Mm, Hh^Fms, Gs^Fms, Gs, Gd, Gd, Hhd, Hhd, Md, Hhd^Vd, Md, Md, Hhd, Hhd, Md, Hhd, Hhd, Hhd, Uh, Uh, Uh, Uh, Uh, Uh, Uh, Uh, Uh, Xu, Uh
Mm, Hh, Hh, Hh, Hh, Hh, Mm, Mm, Mm, Hh^Fms, Hh^Fms, Gs, Gd, Hhd, Hhd, Hhd, Hhd, Hhd, Md, Hhd, Hhd, Md, Md, Md, Hhd, Hhd, Hhd, Uh, Xu, Xu, Xu, Xu, Xu, Xu, Xu, Xu
Mm, Mm, Mm, Mm, Mm, Hh, Hh, Mm, Hh, Mm, Hh, Gs, Gs, Gd, Hhd, Md, Hhd, Hhd, Hhd, Md, Hhd^Fmf, Hhd, Hhd, Md, Hhd, Md, Md, Hhd, Xu, Xu, Xu, Xu, Xu, Xu, Xu, Xu
Mm, Mm, Mm, Mm, Mm, Mm, Mm, Mm, Hh^Fms, Hh, Hh^Fms, Hh^Fms, Hhd, Gd, Hhd, Hhd, Hhd, Hhd, Hhd, Hhd^Fmf, Hhd^Fmf, Md, Md, Hhd, Hhd, Hhd, Hhd, Md, Xu, Xu, Uh, Xu, Uu, Uh, Xu, Xu
Mm, Mm, Mm, Mm, Mm, Mm, Mm, Mm, Mm, Mm, Mm, Mm, Md, Md, Md, Md, Md, Hhd, Md, Md, Md, Md, Md, Hhd, Md, Md, Hhd, Md, Xu, Xu, Uu, Uu, Ur, Uu, Uu^Tf, Xu
Xu, Xu, Xu, Xu, Xu, Xu, Xu, Xu, Xu, Xu, Xu, Xu, Xu, Xu, Xu, Xu, Xu, Xu, Xu, Xu, Xu, Xu, Xu, Xu, Xu, Xu, Xu, Xu, Xu, Xu, Uu, Uu, Uu, Ur, Uu, Xu
Xu, Xu, Xu, Xu, Xu, Xu, Xu, Xu, Xu, Xu, Xu, Xu, Xu, Xu, Xu, Xu, Xu, Xu, Xu, Xu, Xu, Xu, Xu, Xu, Xu, Xu, Xu, Uu, Uu, Uu, Xu, Xu, Uu, Ur, Uu, Xu
Uu, Uu, Uu, Uu, Uu, Uu, Uu, Uu, Uu, Uu, Uu, Uu, Uu, Uu, Uu, Uu, Uu, Uu^Tf, Uu, Uu, Uu, Xu, Xu, Uh, Uu, Uu, Uu, Xu, Xu, Xu, Xu, Uu, Uu, Ur^Vu, Uu, Xu
Ds, Dd, Ds^Es, Dd, Dd^Es, Uu, Dd, Dd, Dd, Dd, Dd, Dd^Es, Dd, Dd^Es, Dd, Dd^Es, Dd, Dd^Es, Dd^Es, Uu^Vu, Dd^Es, Uu, Uu, Xu, Xu, Uu^Es, Uu, Xu, Uu, Uu, Uu, Uu, Xu, Uu, Xu, Xu
Ds, Ds^Es, Ds, Dd^Vdt, Ds, Dd, Ds, Ds^Es, Ds, Ds^Es, Ds, Ds^Es, Ds, Ds, Ds, Ds, Ds, Ds^Es, Ds^Es, Dd^Es, Ds, Dd^Es, Uu, Xu, Xu, Uu^Vu, Xu, Uu, Xu, Uu, Xu, Xu, Xu, Xu, Xu, Xu
Wwt, Ds, Wwt, Ds, Wwt, Ds, Wwt, Ds, Wwt, Wwt, Wwt, Wwt, Wwt, Wwt, Wwt, Wwt, Wwt, Wwt, Wwt, Ds, Wwt, Ds, Uu, Xu, Xu, Xu, Xu, Xu, Xu, Xu, Xu, Xu, Uu, Xu, Uu, Xu
Wwt, Wwt, Wwt, Wwt, Wwt, Wwt, Wwt, Wwt, Wwt, Wwt, Wwt, Wwt, Wot, Wwt, Wot, Wwt, Wwt, Wwt, Wwt, Wwt, Wwt, Ds, Ds, Uu^Tf, Uu, Uu, Uu, Xu, Uu, Xu, Uu, Uu, Uu, Uu^Vu, Uu, Uu
Ds, Ds, Wwt, Wwt, Ds, Ds, Ds, Ds, Ds, Ds, Wwt, Wwt, Wwt, Wot, Wot, Wwt, Uue, Uue, Uue, Wwt, Wot, Wwt, Ds, Ds, Ds, Dd, Ds^Es, Uu, Ds, Uu, Ds, Ds, Ds, Ds, Ds, Uu
Dd^Es, Ds, Ds, Wwt, Wwt, Ds, Ds^Es, Ds^Es, Ds, Ds, Ds, Wwt, Wwt, Wot, Wwt, Wwt, Ww, Uue, Uue, Wwt, Wot, Wwt, Wwt, Wwt, Wwt, Ds^Es, Wwt, Ds, Wwt, Ds, Wwt, Wwt, Wwt, Wwt, Wwt, Ds
Uu, Dd^Es, Dd^Es, Ds, Ds^Vda, Ds, Ds^Es, Ds, Ds, Ds, Ds, Wwt, Wwt, Wwt, Wwt, Wwt, Wwt, Uue, Wwt, Wwt, Wwt, Wwt, Wwt, Wwt, Ds, Wwt, Ds, Wwt, Wwt, Wwt, Ds, Ds, Ds, Ds, Ds, Wwt
Xu, Uu, Uu, Ce, Ce, Ce, Ce, Ds^Es, Ds, Ds^Es, Ds^Es, Ds, Ds^Es, Ds, Wwt, Wot, Wwt, Wwt, Wwt, Ds, Ds, Ds, Ds, Ds, Dd^Es, Ds, Dd, Ds, Ds^Es, Ds, Uu, Uu, Uu, Uu, Uu, Ds
Md, Xu, Xu, Xu, 3 Ke, Ce, Ce, Dd, Ds, Ds^Vda, Ds^Es, Ds^Es, Ds^Es, Ds, Ds, Wwt, Ds, Ds, Ds, Ds, Uu, Uu, Uu, Dd^Es, Uu, Dd^Es, Uu, Uu, Uu, Uu, Xu, Xu, Xu, Xu, Xu, Uu
Md, Xu, Xu, Re, Xu, Xu, Uu, Dd, Dd, Dd^Es, Dd^Es, Dd, Dd, Ds, Dd^Es, Ds, Dd, Dd^Vdt, Dd^Es, Uu, Uh, Uh, Uh, Uu, Uh, Uu, Uh, Uh, Uh, Uh, Uh, Uh, Uh, Xu, Xu, Xu
Md, Md, Md, Xu, Xu, Xu, Xu, Uu, Uu, Uu, Uu, Uu, Uu, Dd^Es, Uu, Dd^Es, Uu^Tf, Dd^Es, Uu, Uu, Uh, Qxu, Qxu, Uh, Uh, Uh, Qxu, Qxu, Qxu, Qxu, Qxu, Uh, Uh, Uh, Uh, Xu
Hhd^Ftp, Md, Md, Md, Md, Xu, Xu, Uu, Uu, Uu, Uu, Uu, Uu, Uu, Uu, Uu, Uu, Uu, Uu, Uh, Uh, Qxu, Qxu, Qxu, Uh, Uh, Qxu, Qxu, Qxu, Qxu, Qxu, Uh, Qxu, Uh, Uh^Vhcr, Uu
Hhd^Ftp, Hhd^Ftp, Hhd^Ftp, Hhd, Hhd, Md, Md, Xu, Xu, Xu, Xu, Xu, Xu, Xu, Xu, Xu, Uu, Uu, Uu, Uh, Uh, Qxu, Qxu, Qxu, Uh, Uh, Uh, Qxu, Uh, Qxu, Uh, Qxu, Uh, Uh, Uh, Uh
Gd, Hhd^Ftp, Gd, Hhd, Gd, Hhd, Hhd^Ftp, Md, Md, Mm, Hhd, Md, Md, Md, Md, Xu, Xu, Xu, Xu, Xu, Xu, Uh, Uh, Uu, Uh, Uh, Uh, Uh, Uh, Uh, Uh, Uh, Uu, Uh, Ds, Uu
