Hh^Fms, Gs^Qhu, Gs^Qhu, Gd^Qhu, Gd^Qhu, Gd^Qhu, Hhd, Hhd, Hhd, Hhd, Md, Hhd, Hhd, Hhd, Hhd, Md, Md, Hhd, Hhd, Hhd, Md, Md, Hhd, Uh, Uh^Qhh, Uh^Qhh, Uh^Qhh, Uh^Qhh, Xu^Qhh, Xu, Xu^Qhh, Xu^Qhh, Xu^Qhh, Xu^Qhh, Xu^Qhh, Xu
Hh^Fms, Gs^Fds, Hh^Fds, Gs^Qhu, Gs^Qhu, Gd^Qhu, Hhd, Hhd, Hhd, Hhd, Hhd, Hhd, Md, Hhd, Hhd, Md, Hhd^Fmf, Hhd^Fmf, Hhd^Fmf, Md, Md, Hhd, Uh^Qhh, Uh^Qhh, Uh, Uh, Uh^Qhh, Uh^_mh, Uh^Qhh, Uh^Qhh, Uh^Qhh, Uh, Uh, Xu^Qhh, Xu, Xu^Qhh
Mm, Hh^Vht, Mm, Hh^Fds, Gs^Fds, Gd^Qhu, Gd^Qhu, Hhd, Gd^Qhu, Hhd, Hhd, Hhd, Hhd, Md, Hhd, Hhd, Md, Hhd^Fmf, Md, Md, Hhd, Hhd, Uh^Qhh, Uh^Vd, Uh^Qhh, Uh^Qhh, Ql, Uh^Qhh, Ql, Ql, Uh^Qhh, Uh^Qhh, Uh^Qhh, Uh^_mh, Uh, Uh
Mm, Mm, Mm, Hh^Fms, Hh^Fds, Gs^Qhu, Gs^Qhu, Gd^Qhu, Gd^Qhu, Gd^Qhu, Hhd, Hhd, Hhd, Md, Hhd, Md, Md, Hhd, Md, Md, Hhd, Uh^Qhh, Ce, Uh, Uh^Qhh, Ql, Ql, Ql, Ql, Ql, Ql, Ql, Uh^Qhh, Uh^Qhh, Uh^Qhh, Uh^Qhh
Mm, Mm, Mm, Hh^Fms, Hh^Fms, Gs^Fms, Gs^Fms, Gs^Qhu, Gd^Qhu, Gd^Qhu, Hhd, Hhd^Vd, Hhd, Hhd, Hhd, Hhd, Hhd, Hhd, Md, Md, Hhd, Ce^Qhh, 5 Ke, Ce, Uh^Qhh, Ql, Ql, Ql, Ql, Ql, Ql, Ql, Ql, Ql, Ql, Ql
Mm, Mm, Mm, Mm, Mm, Hh^Fms, Gs^Fms, Gs^Qhu, Gs^Qhu, Gd^Qhu, Gd^Qhu, Hhd, Hhd, Hhd, Hhd, Md, Hhd, Md, Hhd, Md, Hhd, Ce^Qhh, Ce, Ce, Uh^Qhh, Uh^Qhh, Ql, Ql, Ql, Ql, Ql, Ql, Ql, Ql, Ql, Ql
Mm, Mm, Mm, Mm, Hh, Hh^Fms, Hh^Fms, Gs^Fds, Gs^Qhu, Gs^Qhu, Gd^Qhu, Hhd, Hhd, Hhd, Md, Hhd, Hhd, Hhd, Hhd, Md, Hhd, Uh^Qhh, Uh^Qhh, Uh, Uh^Qhh, Ql, Ql, Ql, Ql, Ql, Ql, Ql, Ql, Ql, Ql, Ql
Mm, Mm, Mm, Mm, Mm, Mm, Mm, Hh^Fms, Gs^Fms, Gs^Qhu, Gd^Qhu, Hhd, Hhd^Fmf, Hhd^Fmf, Hhd^Fmf, Hhd, Md, Hhd, Md, Md, Md, Hhd, Cer^Qhh, 1 Kerg, Cer, Uh^Qhh, Uh^Qhh, Uh^Qhh, Uh^Qhh, Ql, Ql, Ql, Ql, Ql, Uh^Qhh, Uh^Qhh
Mm, Mm, Mm, Mm, Mm, Mm, Mm, Hh^Fms, Hh^Fms, Gs^Qhu, Gd^Qhu, Gd^Qhu, Hhd, Hhd^Fmf, Hhd, Hhd, Hhd, Hhd, Hhd^Fmf, Hhd, Md, Hhd, Uh^Qhh, Cer, Uh, Uh, Uh, Uh^Qhh, Ql, Ql, Uh^Qhh, Ql, Ql, Ql, Uh^Qhh, Uh^Qhh
Hh, Mm, Hh^Vc, Mm, Mm, Mm, Mm, Mm, Hh^Fms, Gs^Fds, Gs^Qhu, Gd^Qhu, Hhd, Md, Hhd, Hhd, Hhd, Hhd^Fmf, Hhd^Fmf, Hhd^Fmf, Hhd, Hhd, Hhd, Uh^Qhh, Uh^Qhh, Uh^Vd, Uh^_mh, Uh^Qhh, Uh^Qhh, Uh^Qhh, Uh^Qhh, Uh^Qhh, Uh^Qhh, Uh^Qhh, Uh^Qhh, Uh^Qhh
Hh, Hh, Hh, Hh, Hh, Mm, Hh, Mm, Hh^Fms, Gs^Fms, Gs^Qhu, Gd^Qhu, Gd^Qhu, Hhd, Hhd, Md, Hhd^Vd, Md, Md, Hhd, Hhd, Md, Hhd, Hhd, Hhd, Uh^Qhh, Uh^Qhh, Uh, Uh^Qhh, Uh^Qhh, Uh^Qhh, Uh^Qhh, Uh^Qhh, Uh^Qhh, Xu, Uh^Qhh
Mm, Hh, Hh, Hh, Hh, Hh, Mm, Mm, Mm, Hh^Fms, Hh^Fms, Gs^Qhu, Gd^Qhu, Hhd, Hhd, Hhd, Hhd, Hhd, Md, Hhd, Hhd, Md, Md, Md, Hhd, Hhd, Hhd, Uh^Qhh, Xu, Xu, Xu, Xu, Xu, Xu, Xu, Xu
Mm, Mm, Mm, Mm, Mm, Hh, Hh, Mm, Hh, Mm, Hh, Gs^Qhu, Gs^Qhu, Gd^Qhu, Hhd, Md, Hhd, Hhd, Hhd, Md, Hhd^Fmf, Hhd, Hhd, Md, Hhd, Md, Md, Hhd, Xu, Xu, Xu, Xu, Xu, Xu, Xu, Xu
Mm, Mm, Mm, Mm, Mm, Mm, Mm, Mm, Hh^Fms, Hh, Hh^Fms, Hh^Fms, Hhd, Gd^Qhu, Hhd, Hhd, Hhd, Hhd, Hhd, Hhd^Fmf, Hhd^Fmf, Md, Md, Hhd, Hhd, Hhd, Hhd, Md, Xu, Xu, Uh, Xu, Uu, Uh, Xu, Xu
Mm, Mm, Mm, Mm, Mm, Mm, Mm, Mm, Mm, Mm, Mm, Mm, Md, Md, Md, Md, Md, Hhd, Md, Md, Md, Md, Md, Hhd, Md, Md, Hhd, Md, Xu, Xu, Uu, Uu, Ur, Uu, Tb^Tf, Xu
Xu, Xu, Xu, Xu, Xu, Xu, Xu, Xu, Xu, Xu, Xu, Xu, Xu, Xu, Xu, Xu, Xu, Xu, Xu, Xu, Xu, Xu, Xu, Xu, Xu, Xu, Xu, Xu, Xu, Xu, Uu^Qhu, Uu, Uu, Ur, Uu, Xu
Xu, Xu, Xu, Xu, Xu, Xu, Xu, Xu, Xu, Xu, Xu, Xu, Xu, Xu, Xu, Xu, Xu, Xu, Xu, Xu, Xu, Xu, Xu, Xu, Xu, Xu, Xu, Uu, Uu^Qhu, Uu^Qhu, Xu, Xu, Uu, Ur, Uu, Xu
Uu, Uu, Uu, Uu, Uu, Uu, Uu, Uu, Uu, Uu, Uu, Uu, Uu, Uu, Uu, Uu, Tb^Tf, Tb^Tf, Uu, Uu, Uu, Xu, Xu, Uh, Uu, Uu^Qhh, Uu^Qhh, Xu, Xu, Xu, Xu, Uu, Uu, Ur^Vu, Tb^Tf, Xu
Ds, Dd, Ds^Es, Dd, Dd^Es, Uu, Dd, Dd, Dd, Dd, Dd, Dd^Es, Dd, Dd^Es, Dd, Dd^Es, Dd, Dd^Es, Dd^Es, Uu^Vct, Dd^Es, Uu, Uu, Xu, Xu, Uu^Es, Uu, Xu, Uu, Uu^Qhh, Uu^Qhh, Uu^Qhh, Xu, Uu, Xu, Xu
Ds, Ds^Es, Ds, Dd^Vct, Ds, Dd, Ds, Ds^Es, Ds, Ds^Es, Ds, Ds^Es, Ds, Ds, Ds, Ds, Ds, Ds^Es, Ds^Es, Dd^Es, Ds, Dd^Es, Uu, Xu, Xu, Uu^Vu, Xu, Uu, Xu, Uu^Qhh, Xu, Xu, Xu, Xu, Xu, Xu
Wwt, Ds, Wwt, Ds, Wwt, Ds, Wwt, Ds, Wwt, Wwt, Wwt, Wwt, Wwt, Wwt, Wwt, Wwt, Wwt, Wwt, Wwt, Ds, Wwt, Ds, Uu, Xu, Xu, Xu, Xu, Xu, Xu, Xu, Xu, Xu, Tb^Tf, Xu, Uu, Xu
Wwt, Wwt, Wwt, Wwt, Wwt, Wwt, Wwt, Wwt, Wwt, Wwt, Wwt, Wwt, Wot, Wwt, Wot, Wwt, Wwt, Wwt, Wwt, Wwt, Wwt, Ds, Ds, Tb^Tf, Tb^Tf, Uu, Uu, Xu, Uu, Xu, Uu, Tb^Tf, Tb^Tf, Uu, Uu, Uu
Ds, Ds, Wwt, Wwt, Ds, Ds, Ds, Ds, Ds, Ds, Wwt, Wwt, Wwt, Wot, Wot, Wwt, Uue^Qhh, Uue^Qhh, Uue^Qhh, Wwt, Wot, Wwt, Ds, Ds, Ds, Dd, Ds^Es, Uu, Ds, Uu, Ds, Ds, Ds, Ds, Ds, Uu
Dd^Es, Ds, Ds, Wwt, Wwt, Ds, Ds^Es, Ds^Es, Ds^Vct, Ds, Ds, Wwt^Bw/r, Wwt, Wot, Wwt, Wwt, Ww, Uue^Qhh, Uue^Qhh, Wwt, Wot, Wwt, Wwt, Wwt, Wwt, Ds^Es, Wwt, Ds, Wwt, Ds, Wwt, Wwt, Wwt, Wwt, Wwt, Ds
Uu^Qhh, Dd^Es, Dd^Es, Ds, Ds^Vct, Ds, Ds^Es, Ds, Ds, Ds, Ds, Wwt, Wwt, Wwt, Wwt, Wwt, Wwt, Uue^Qhh, Wwt, Wwt, Wwt, Wwt, Wwt, Wwt, Ds, Wwt, Ds, Wwt, Wwt, Wwt, Ds, Ds, Ds, Ds, Ds, Wwt
Xu, Uu^Qhh, Uu^Qhh, Cer, Cer, Cer, Cer, Ds^Es, Ds, Ds^Es, Ds^Es, Ds, Ds^Es, Ds, Wwt, Wot, Wwt, Wwt, Wwt, Ds, Ds, Ds, Ds, Ds, Dd^Es, Ds, Dd, Ds, Ds^Es, Ds, Tb^Tf, Tb^Tf, Tb^Tf, Uu, Uu, Ds
Md, Xu, Xu, Xu, 3 Ker, Cer, Cer, Dd, Ds, Ds^Vct, Ds^Es, Ds^Es, Ds^Es, Ds, Ds, Wwt, Ds, Ds, Ds, Ds, Uu, Uu, Uu, Dd^Es, Uu, Dd^Es, Uu, Uu, Uu, Uu, Xu, Xu, Xu, Xu, Xu, Uu
Md, Xu, Xu, Re, Xu, Xu, Uu^Qhh, Dd, Dd, Dd^Es, Dd^Es, Dd, Dd, Ds, Dd^Es, Ds, Dd, Dd^Vct, Dd^Es, Uu, Uh^Qhh, Uh^Qhh, Uh^Qhh, Uu, Uh^Qhh, Uu, Uh^Qhh, Uh^Qhh, Uh^Qhh, Uh^Qhh, Uh^Qhh, Uh^Qhh, Uh^Qhh, Xu, Xu, Xu
Md, Md, Md, Xu, Xu, Xu, Xu, Uu^Qhh, Uu^Qhh, Uu^Qhh, Uu^Qhh, Uu^Qhh, Uu^Qhh, Dd^Es, Uu^Qhh, Dd^Es, Tb^Tf, Dd^Es, Uu, Uu, Uh^Qhh, Qxu, Qxu, Uh^Qhh, Uh^Qhh, Uh^Qhh, Qxu, Qxu, Qxu, Qxu, Qxu, Uh^Qhh, Uh^Qhh, Uh^Qhh, Uh^Qhh, Xu
Hhd^Ftp, Md, Md, Md, Md, Xu, Xu, Uu^Qhh, Uu^Qhh, Uu^Qhh, Uu^Qhh, Uu^Qhh, Uu^Qhh, Uu^Qhh, Uu^Qhh, Uu^Qhh, Tb^Tf, Uu, Uu, Uh^Qhh, Uh^Qhh, Qxu, Qxu, Qxu, Uh^Qhh, Uh^Qhh, Qxu, Qxu, Qxu, Qxu, Qxu, Uh^Qhh, Qxu, Uh^Qhh, Uh^Vhcr, Uu^Qhh
Hhd^Ftp, Hhd^Ftp, Hhd^Ftp, Hhd, Hhd, Md, Md, Xu, Xu, Xu, Xu, Xu, Xu, Xu, Xu, Xu, Tb^Tf, Tb^Tf, Tb^Tf, Uh^Qhh, Uh^Qhh, Qxu, Qxu, Qxu, Uh^Qhh, Uh^Qhh, Uh^Qhh, Qxu, Uh^Qhh, Qxu, Uh^Qhh, Qxu, Uh^Qhh, Uh^Qhh, Uh^_mh, Uh^Qhh
Gd, Hhd^Ftp, Gd, Hhd, Gd, Hhd, Hhd^Ftp, Md, Md, Mm, Hhd, Md, Md, Md, Md, Xu, Xu, Xu, Xu, Xu, Xu, Uh^Qhh, Uh^Qhh, Uu^Qhh, Uh^Qhh, Uh^Qhh, Uh^Qhh, Uh^Qhh, Uh^Qhh, Uh^Qhh, Uh^Qhh, Uh^Qhh, Uu, Uh^Qhh, Ds, Uu
