border_size=1
usage=map

Xue, Xue, Xue, Xue, Xue, Xue, Xue, Xue, Xue, Xue, Xue, Xue, Xue, Xue, Xue, Xue, Xue, Xue, Xue, Xue, Xue, Xue, Xue, Xue, Xue, Xue, Xue, Xue, Xue, Xue, Xue, Xue, Xue, Xue, Xue, Xue, Uue, Xue, Uue, Xue, Uue, Xue, Xue, Xue, Xue, Xu
Uue, Uue, Uue, Uue, Uue, Uue, Uue, Uue, Uue, Uue, Uue, Uue, Uue, Uue, Uue, Uue, Uue, Uue, Uue, Uue, Uue, Uue, Xue, Xue, Xue, Xue, Xue, Xue, Xue, Xue, Xue, Xue, Uue, Xue, Uue, Uue, Urb, Uue, Uue^Vhcr, Uue, Urb, Uue, Uue, Xue, Uue, Xue
Urb, Urb, Urb, Urb, Urb, Urb, Urb, Urb, Urb, Urb, Urb, Urb, Urb, Urb, Urb, Urb, Urb, Uue, Urb, Uue, Uue, Uue, Uue, Xue, Xue, Xue, Xue, Xue, Xue, Xue, Xue, Uue, Uue, Uue, Urb, Urb, Urb, Urb, Urb, Urb, Urb, Urb, Urb, Uue, Uue, Uue
Uue, Urb, Uue, Urb, Uue, Urb, Urb, Urb, Urb, Urb, Uue, Urb, Uue, Urb, Uue, Urb, Urb, Urb, Urb, Urb, Urb, Urb, Uue, Uue, Xue, Xue, Xue, Xue, Uue, Uue, Uue, Uue, Urb, Urb, Urb, Urb, Urb, Urb, Urb, Urb, Urb, Urb, Urb, Urb, Urb, Uue
Xu, Uue, Xue, Uue, Xue, Uue, Uue, Urb, Uue, Uue, Xue, Uue, Xue, Uue, Uue, Uue, Uue, Urb, Uue, Urb, Urb, Urb, Urb, Uue, Uue, Xue, Xue, Xue, Uue, Uue, Urb, Urb, Urb, Urb, Uue, Uue, Uue, Urb, Urb, Urb, Uue, Uue, Uue, Urb, Urb, Urb
Xu, Xue, Xue, Xue, Xue, Xue, Uue, Urb, Uue, Xue, Uue, Xue, Xue, Xue, Xue, Uue, Uue, Uue, Uue^Vhcr, Uue, Urb, Urb, Urb, Uue, Uue, Xue, Xue, Xue, Uue, Urb, Urb, Urb, Uue, Uue, Xue, Uue^Tf, Uue, Urb, Urb, Urb, Uue, Uue^Tf, Xue, Uue, Uue, Urb
Xue, Xue, Xue, Xue, Uue, Uue, Uue, Uue, Uue, Uue, Uue, Uue, Uue, Xue, Xue, Xue, Xue, Uue, Uue, Uue, Urb, Urb, Urb, Uue^Tf, Urb, Uue, Xue, Uue, Uue, Urb, Urb, Uue, Uue, Xue, Xue, Xos^Efs, Urb, Chw, Urb, Chw, Urb, Xos^Efs, Xue, Xue, Uue, Uue
Xue, Xue, Uue, Uue, Dd, Uue, Dd, Dd, Dd^Es, Dd, Dd^Es, Dd, Dd, Uue, Xue, Xue, Xue, Xue, Xue, Uue, Uue, Urb, Urb, Urb, Urb, Uue, Uue, Xue, Uue, Urb, Urb, Uue, Uue, Xue, Xue, Xos^Efs, Urb, Urb, Urb, Urb, Urb, Xos^Efs, Xue, Xue, Uue, Uue
Xue, Uue, Uue, Dd, Dd^Vdt, Dd, Dd, Dd, Dd, Dd^Es, Dd, Dd^Es, Dd^Es, Uue, Uue, Uue, Uue, Xue, Xue, Uue, Uue, Uue, Uue, Urb, Urb, Urb, Urb, Uue, Urb, Urb, Urb, Uue, Uue, Xue, Xue, Xos^Efs, Urb, Urb, Urb, Urb, Urb, Xos^Efs, Xue, Xue, Uue, Uue
Uue, Uue, Dd, Dd, Dd, Dd, Dd, Dd, Dd, Dd, Dd, Dd^Dr, Dd, Dd, Dd, Dd, Uue, Xue, Xue, Xue, Xue, Uue, Uue, Urb, Uue, Urb, Urb, Urb, Urb, Urb, Uue, Uue, Uue, Xue, Xue, Xos^Efs, Urb, Urb, Urb, Urb, Urb, Xos^Efs, Xue, Xue, Uue, Uue
Dd, Dd, Dd^Es, Dd, Wwt, Dd, Wwt, Dd, Wwt, Dd, Dd, Dd, Dd, Dd^Es, Dd^Es, Dd, Dd, Uue, Uue, Xue, Xue, Xue, Xue, Uue, Uue, Urb, Urb, Urb, Uue, Uue, Uue, Uue^Vhcr, Uue, Xue, Xue, Xos^Efs, Urb, Urb, Urb, Urb, Urb, Xos^Efs, Xue, Xue, Uue, Uue
Dd, Dd^Es, Dd, Dd, Wwt, Wwt, Wwt, Wwt, Wwt, Wwt, Wwt, Wwt, Wwt, Dd, Dd, Dd^Es, Dd, Dd, Uue, Uue, Xue, Xue, Xue, Uue, Uue, Uue, Urb, Urb, Uue, Xue, Xue, Uue, Xue, Xue, Xue, Xos^Efs, Urb, Urb, Urb, Urb, Urb, Xos^Efs, Xue, Xue, Xue, Uue
Dd^Es, Dd^Es, Dd, Wwt, Wwt, Wwt, Wot, Wwt, Wot, Wwt, Wwt, Wwt, Wwt, Dd, Dd, Dd, Dd^Vdt, Dd^Es, Dd, Uue, Uue, Xue, Xue, Xue, Uue, Urb, Urb, Uue, Uue, Uue, Xue, Xue, Xue, Xue, Xos^Efs, Xos^Efs, Urb, Urb, Urb, Urb, Urb, Xos^Efs, Xos^Efs, Xue, Xue, Xue
Dd, Dd, Wwt, Wwt, Wwt, Wwt, Wot, Wot, Wot, Wot, Wwt, Wwt, Wwt, Wwt, Wwt, Dd, Dd, Dd, Dd^Es, Uue, Uue, Xue, Xue, Uue, Urb, Urb, Uue, Uue, Xue, Xue, Xue, Xue, Xos^Efs, Xos^Efs, Urb, Urb, Urb, Urb, Urb, Urb, Urb, Urb, Urb, Xos^Efs, Xos^Efs, Xue
Dd, Dd, Dd, Wwt, Wwt, Wot, Wot, Wot, Wot, Wot, Wot, Wwt, Wwt, Wwt, Dd, Dd, Dd^Es, Dd, Dd^Es, Uue, Uue, Xue, Xue, Uue, Urb^Vhcr, Uue, Xue, Xue, Xue, Xue, Xos^Efs, Xos^Efs, Urb, Urb, Urb, Urb^Vhcr, Urb, Urb, Urb, Urb, Urb, Urb^Vhcr, Urb, Urb, Urb, Xos^Efs
Dd, Dd, Wwt, Wwt, Wwt, Wot, Wot, Wot, Wot, Wwt, Wwt, Wwt, Wwt, Wwt, Dd, Dd, Dd^Es, Dd^Es, Uue, Uue, Xue, Xue, Xue, Uue, Uue, Uue, Xue, Xue, Xos, Xos^Efs, Urb, Urb, Urb, Urb, Urb, Urb, Urb, Urb, Chw, Urb, Urb, Urb, Urb, Urb, Urb, Urb
Dd, Dd, Dd, Wwt, Wwt, Wwt, Wot, Wot, Wwt, Wwt, Wwt, Wwt, Wwt, Dd, Dd^Dr, Dd, Dd, Dd, Uue, Uue, Xue, Xue, Uue, Uue, Uue, Uue, Xue, Xue, Xos^Efs, Urb, Urb, Urb, Urb, Urb, Chw, Urb, Urb, Urb, Urb, Urb, Urb, Urb, Chw, Urb, Urb, Urb
Dd, Dd, Dd, Wwt, Wwt, Wot, Wot, Wot, Wwt, Wwt, Wwt, Dd, Dd, Dd, Dd^Es, Dd, Uue^Tf, Uue, Xue, Xue, Xue, Xue, Uue, Uue, Uue, Uue, Xue, Xue, Xos^Efs, Urb, Urb, Urb^Vhcr, Urb, Urb, Urb, Urb, Urb, Urb, Urb, Urb, Urb, Urb, Urb, Urb, Urb, Urb^Vhcr
Dd, Dd^Vdt, Dd, Wwt, Wwt, Wwt, Wot, Wot, Wwt, Wwt, Dd, Dd, Dd^Es, Dd, Dd, Dd, Uue, Uue, Xue, Xue, Uue, Uue, Uue, Uue, Uue, Uue^Tf, Xue, Xue, Xos^Efs, Urb, Urb, Urb, Urb, Urb, Urb, Urb, Urb, Urb, Chw, Urb, Urb, Urb, Urb, Urb, Urb, Urb
Dd, Dd, Wwt, Wwt, Wwt, Wot, Wot, Wwt, Wwt, Wwt, Wwt, Dd, Dd, Dd^Vdt, Dd, Dd, Uue, Uue, Xue, Xue, Uue, Uue, Uue, Uue, Uue, Uue, Xue, Xue, Xos^Efs, Urb, Urb, Urb, Chw, Urb, Urb, Urb, Urb, Chw, Chw, Chw, Urb, Urb, Urb, Urb, Chw, Urb
Dd, Dd, Wwt, Wwt, Wot, Wot, Wwt, Wwt, Wwt, Wwt, Dd, Dd, Dd^Es, Dd, Dd, Uue, Uue, Uue, Xue, Xue, Uue^Tf, Uue, Uue, Uue, Uue, Uue, Xue, Xue, Xos^Efs, Urb, Urb, Urb, Urb, Urb, Urb, Urb, Urb, Chw, Chw, Chw, Urb, Urb, Urb, Urb, Urb, Urb
Wwt, Wwt, Wwt, Wwt, Wot, Wot, Wwt, Wwt, Wwt, Wwt, Dd, Dd, Dd^Es, Dd, Dd, Uue, Uue, Uue, Xue, Xue, Uue, Uue, Uue, Uue, Uue, Uue, Xue, Xue, Xos^Efs, Urb, Urb, Urb, Urb, Urb, Urb, Urb, Urb, Urb, Urb, Urb, Urb, Urb, Urb, Urb, Urb, Urb
Wwt, Wwt, Wwt, Wwt, Wwt, Wwt, Wwt, Wwt, Wwt, Dd, Dd, Dd, Dd^Es, Dd, Uue, Uue, Uue, Uue, Xu, Xue, Uue, Uue, Uue, Urb^Vhcr, Uue, Uue, Xue, Xue, Xos^Efs, Urb, Urb, Urb^Vhcr, Urb, Urb, Chw, Urb, Urb, Urb, Urb, Urb, Urb, Urb, Chw, Urb, Urb, Urb^Vhcr
Wwt, Wwt, Wot, Wot, Wwt, Wwt, Wwt, Wwt, Dd, Dd, Dd, Dd^Dr, Dd^Es, Dd, Uue, Uue, Xue, Xue, Xue, Xue, Uue, Uue, Urb, Urb, Urb, Uue, Uue, Xue, Xos^Efs, Urb, Urb, Urb, Urb, Urb, Urb, Urb, Urb, Chw, 2 Khw, Chw, Urb, Urb, Urb, Urb, Urb, Urb
Wot, Wwt, Wwt, Wwt, Wwt, Wwt, Wwt, Dd, Dd, Dd, Dd, Dd, Dd, Dd, Dd, Uue, Xue, Xue, Xue, Xue, Uue, Uue, Urb, Uue, Uue, Urb, Urb, Uue, Urb, Xos, Xos^Efs, Urb, Urb, Urb, Urb, Urb, Urb, Urb, Urb, Urb, Urb, Urb, Urb, Urb, Urb, Urb
Wot, Wot, Wwt, Wwt, Dd, Wwt, Dd, Dd, Dd, Dd^Vdt, Dd^Es, Dd^Es, Dd, Dd, Uue, Uue, Uue, Xue, Xue, Uue, Uue, Uue, Urb, Uue, Uue, Uue, Uue, Urb, Urb, Urb, Urb, Xos^Efs, Xos^Efs, Urb, Urb, Urb^Vhcr, Urb, Urb, Urb, Urb, Urb, Urb^Vhcr, Urb, Urb, Xos^Efs, Xos^Efs
Wwt, Wwt, Wwt, Dd, Dd, Dd, Dd, Dd^Es, Dd, Dd, Dd, Dd, Dd, Dd, Dd, Uue, Uue, Xue, Xue, Uue, Uue, Uue, Ce, Uue, Uue, Uue, Uue, Uue, Xos^Efs, Urb, Urb, Urb, Urb, Xos^Efs, Xos^Efs, Urb, Urb, Urb, Urb, Urb, Urb, Urb, Xos^Efs, Xos^Efs, Urb, Urb
Wwt, Wwt, Dd, Dd, Dd^Es, Dd^Dr, Dd, Dd, Dd, Dd, Ce, Ce, Ce, Dd, Uue, Uue, Xue, Xue, Xue, Uue, Uue, Ce, 3 Ke, Ce, Uue, Uue, Xue, Xue, Xue, Xos^Efs, Xos^Efs, Urb, Urb, Urb, Urb, Xos^Efs, Urb, Urb, Urb, Urb, Urb, Xos^Efs, Urb, Urb, Urb, Urb
Wwt, Wwt, Dd^Es, Dd^Es, Dd, Dd, Dd, Uue, Uue, Uue, Ce, 1 Ke, Ce, Uue, Uue, Uue, Uue, Xue, Xue, Uue, Uue, Ce, Ce, Ce, Uue, Uue, Xue, Xue, Xue, Xue, Xue, Xos^Efs, Xos^Efs, Urb, Urb, Urb, Urb, Urb, Urb^Vhcr, Urb, Urb, Urb, Urb, Urb, Xos^Efs, Xos^Efs
Wwt, Dd, Dd, Dd, Dd, Uue, Uue, Uue, Uue, Uue, Uue, Ce, Uue, Uue, Uue, Uue, Uue, Xue, Xue, Uue, Uue, Uue, Uue, Uue, Uue, Uue, Xue, Xue, Xue, Xue, Xue, Xue, Xue, Xos^Efs, Xos^Efs, Urb, Urb, Urb, Urb, Urb, Urb, Urb, Xos^Efs, Xos^Efs, Xue, Xue
Dd, Dd, Dd, Dd^Vdt, Dd, Uue, Uue, Uue, Uue, Uue, Uue, Uue, Uue, Uue, Xue, Xue, Xue, Xue, Xue, Xue, Xue, Uue, Uue, Uue, Xue, Xue, Xue, Xue, Xue, Xue, Xue, Xue, Xue, Xue, Xue, Xos^Efs, Xos^Efs, Urb, Urb, Urb, Xos^Efs, Xos^Efs, Xue, Xue, Xue, Xue
Dd, Dd, Dd, Dd, Uue, Uue, Xue, Xue, Xue, Xue, Xue, Uue, Uue, Uue, Xue, Xue, Xue, Xue, Xu, Xue, Xue, Xue, Xue, Xue, Xu, Xu, Xu, Xu, Xu, Xue, Xue, Xue, Xue, Xue, Xue, Xue, Xue, Urb, Urb, Urb, Xue, Xue, Xue, Xue, Xue, Xue
