Xue^Qhu, Xue^Qhu, Xue^Qhu, Xue^Qhu, Xue^Qhu, Xue^Qhu, Xue^Qhu, Xue^Qhu, Xue^Qhu, Xue^Qhu, Xue^Qhu, Xue^Qhu, Xue^Qhu, Xue, Xue, Xue, Xue, Xue, Xue, Xue, Xue, Xue, Xue, Xue, Xue, Xue, Xue^Qhh, Xue, Xue^Qhh, Xue, Xue, Xue, Xue, Xue, Xue, Xue, Uue, Xue, Uue, Xue, Uue, Xue, Xue, Xue, Xue, Xu
Xue^Qhu, Uue^Dr, Uue, Uue, Uue, Uue, Uue, Uue, Uue, Uue, Uue, Uue^Tf, Uue^Qhu, Uue, Uue, Uue, Uue, Uue, Uue, Uue^Tf, Uue^Tf, Uue^Tf, Xue, Xue, Xue, Xue^Qhh, Xue^Qhh, Xue^Qhh, Xue, Xue, Xue, Xue, Uue^Emf, Xue, Uue^Es, Uue, Urb, Uue, Uue^Vhcr, Uue, Urb, Uue, Uue^Emf, Xue, Uue^Dr, Xue
Xue^Qhu, Urb^Dr, Urb, Urb, Urb, Urb, Urb, Urb, Urb, Urb, Urb, Urb, Urb^Qhu, Urb, Urb, Urb, Urb, Uue, Urb, Uue, Uue, Uue^Tf, Uue, Xue, Xue, Xue, Xue^Qhh, Xue, Xue, Xue, Xue, Uue, Uue, Uue, Urb, Urb, Urb, Urb, Urb, Urb, Urb, Urb, Urb, Uue^Emf, Uue^Dr, Xue
Xue^Qhu, Urb^Dr, Uue, Urb^Em, Uue^Em, Urb, Urb, Urb, Urb, Urb^_ml, Uue, Urb, Uue^Qhu, Urb^Es, Uue, Urb, Urb, Urb, Urb, Urb, Urb, Urb, Uue^Em, Uue, Xue, Xue, Xue^Qhh, Xue, Uue, Uue^Emf, Uue, Uue, Urb, Urb, Urb, Urb, Urb, Urb, Urb, Urb, Urb, Urb, Urb, Urb, Urb^Dr, Xue
Xu^Qhu, Uue^Dr, Xue^Qhu, Uue^Qhu, Xue^Qhu, Uue, Uue^Qhu, Urb, Uue^Qhu, Uue, Xue^Qhu, Uue, Xue^Qhu, Uue^Es, Uue^Es, Uue^Es, Uue^Em, Urb, Uue, Urb, Urb, Urb, Urb, Uue^Es, Uue^Es, Xue, Xue^Qhh, Xue, Uue, Uue^Emf, Urb, Urb, Urb, Urb, Uue^Es, Uue^Em, Uue, Urb^_mh, Urb, Urb, Uue^Es, Uue^Em, Uue, Urb^Dr, Xue, Xue
Xu^Qhu, Xue^Qhu, Xue, Xue^Qhu, Xue, Xue^Qhu, Uue, Urb^Qhu, Uue, Xue^Qhu, Uue, Xue^Qhu, Xue, Xue, Xue, Uue^Em, Uue, Uue^Em, Uue^Vhcr, Uue, Urb, Urb, Urb, Uue, Uue, Xue, Xue^Qhh, Xue, Uue, Urb, Urb, Urb, Uue, Uue^Em, Xue, Uue^Tf, Uue, Urb, Urb, Urb, Uue, Uue^Tf, Xue, Uue^Dr, Xue, Xue
Xue, Xue, Xue, Xue, Uue^Em, Uue^Em, Uue^Es, Uue^Es, Uue^Es, Uue^Em, Uue^Em, Uue^Em, Uue, Xue, Xue, Xue, Xue, Uue, Uue, Uue, Urb, Urb, Urb, Uue^Tf, Urb, Uue, Xue^Qhh, Uue, Uue, Urb, Urb, Uue, Uue^Emf, Xue, Xue, Xoa^Efs, Urb, Chw, Urb, Chw, Urb, Xoa^Efs, Xue, Xue, Xue, Xue
Xue, Xue, Uue, Uue^Em, Dd, Uue, Dd, Dd^Es, Dd^Es, Dd, Dd^Es, Dd, Dd, Uue, Xue, Xue, Xue, Xue, Xue, Uue^Em, Uue^Em, Urb, Urb, Urb, Urb, Uue, Uue, Xue^Qhh, Uue^Qhh, Urb, Urb, Uue, Uue^Emf, Xue, Xue, Xoa^Efs, Urb, Urb, Urb, Urb, Urb, Xoa^Efs, Xue, Xue, Xue, Xue
Xue, Uue, Uue, Dd, Dd^Vdt, Dd, Dd, Dd, Dd, Dd^Es, Dd, Dd^Es, Dd^Es, Uue, Uue, Uue, Uue, Xue, Xue, Uue, Uue^Em, Uue, Uue, Urb, Urb, Urb, Urb, Uue, Urb, Urb^Qhh, Urb^Qhh, Uue, Uue, Xue, Xue, Xoa^Efs, Urb, Urb, Urb, Urb, Urb, Xoa^Efs, Xue, Xue, Xue, Xue
Uue, Uue, Dd, Dd, Dd, Dd, Dd, Dd, Dd, Dd, Dd, Dd^Dr, Dd, Dd, Dd, Dd, Uue, Xue, Xue, Xue, Xue, Uue^Em, Uue, Urb, Uue, Urb, Urb, Urb, Urb, Urb, Uue^Es, Uue^Qhh, Uue^Qhh, Xue, Xue, Xoa^Efs, Urb, Urb, Urb, Urb, Urb, Xoa^Efs, Xue, Xue, Xue, Xue
Dd, Dd, Dd^Es, Dd, Wwt, Dd, Wwt, Dd, Wwt, Dd, Dd, Dd, Dd, Dd^Es, Dd^Es, Dd, Dd, Uue, Uue^Emf, Xue, Xue, Xue, Xue, Uue, Uue, Urb, Urb, Urb, Uue, Uue^Es, Uue, Uue^Vhcr, Uue^Tf, Xue^Qhh, Xue^Qhh, Xoa^Efs, Urb, Urb, Urb, Urb, Urb, Xoa^Efs, Xue, Xue, Xue, Xue
Dd, Dd^Es, Dd, Dd, Wwt, Wwt, Wwt, Wwt, Wwt, Wwt, Wwt, Wwt, Wwt, Dd, Dd, Dd^Es, Dd, Dd, Uue, Uue^Emf, Xue, Xue, Xue, Uue, Uue, Uue, Urb, Urb, Uue, Xue, Xue, Uue^Tf, Xue, Xue, Xue^Qhh, Xoa^Efs, Urb, Urb, Urb, Urb, Urb, Xoa^Efs, Xue, Xue, Xue, Xue
Dd^Es, Dd^Es, Dd, Wwt, Wwt, Wwt, Wot, Wwt, Wot, Wwt, Wwt, Wwt, Wwt, Dd, Dd, Dd, Dd^Vdt, Dd^Es, Dd, Uue^Emf, Uue, Xue, Xue, Xue, Uue, Urb, Urb, Uue, Uue, Uue^Emf, Xue, Xue, Xue^Qhh, Xue^Qhh, Xoa^Efs, Xoa^Efs, Urb, Urb, Urb, Urb, Urb, Xoa^Efs, Xoa^Efs, Xue, Xue, Xue
Dd, Dd, Wwt, Wwt, Wwt, Wwt, Wot, Wot, Wot, Wot, Wwt, Wwt, Wwt, Wwt, Wwt, Dd, Dd, Dd, Dd^Es, Uue, Uue^Em, Xue, Xue, Uue, Urb, Urb, Uue, Uue, Xue, Xue, Xue^Qhh, Xue^Qhh, Xoa^Efs, Xoa^Efs, Urb, Urb, Urb, Urb, Urb, Urb, Urb, Urb, Urb, Xoa^Efs, Xoa^Efs, Xue
Dd, Dd, Dd, Wwt, Wwt, Wot, Wot, Wot, Wot, Wot, Wot, Wwt, Wwt, Wwt, Dd, Dd, Dd^Es, Dd, Dd^Es, Uue^Em, Uue, Xue, Xue, Uue, Urb^Vhcr, Uue, Xue, Xue, Xue^Qhh, Xue^Qhh, Xoa^Efs, Xoa^Efs, Urb, Urb, Urb, Urb^Vhcr, Urb, Urb, Urb, Urb, Urb, Urb^Vhcr, Urb, Urb, Urb, Xoa^Efs
Dd, Dd, Wwt, Wwt, Wwt, Wot, Wot, Wot, Wot, Wwt, Wwt, Wwt, Wwt, Wwt, Dd, Dd, Dd^Es, Dd^Es, Uue^Es, Uue^Em, Xue, Xue, Xue, Uue, Ur, Uue^Emf, Xue, Xue^Qhh, Xos^Qhh, Xoa^Efs, Urb, Urb, Urb, Urb, Urb, Urb, Urb, Urb, Chw, Urb, Urb, Urb, Urb, Urb, Urb, Urb
Dd, Dd, Dd, Wwt, Wwt, Wwt, Wot, Wot, Wwt, Wwt, Wwt, Wwt, Wwt, Dd, Dd^Dr, Dd, Dd, Dd, Uue, Uue, Xue, Xue, Uue, Uue, Ur, Uue, Xue, Xue^Qhh, Xoa^Qhh, Urb, Urb, Urb, Urb, Urb, Chw, Urb, Urb, Urb, Urb, Urb, Urb, Urb, Chw, Urb, Urb, Urb
Dd, Dd, Dd, Wwt, Wwt, Wot, Wot, Wot, Wwt, Wwt, Wwt, Dd, Dd, Dd, Dd^Es, Dd, Uue^Tf, Uue, Xue, Xue, Xue, Xue, Uue, Ur, Uue^Es, Uue^Es, Xue, Xue^Qhh, Xoa^Efs, Urb, Urb, Urb^Vhcr, Urb, Urb, Urb, Urb, Urb, Urb, Urb, Urb, Urb, Urb, Urb, Urb, Urb, Urb^Vhcr
Dd, Dd^Vdt, Dd, Wwt, Wwt, Wwt, Wot, Wot, Wwt, Wwt, Dd, Dd, Dd^Es, Dd, Dd, Dd, Uue, Uue, Xue, Xue, Uue^Emf, Uue^Emf, Uue, Ur, Uue, Uue^Tf, Xue, Xue^Qhh, Xoa^Efs, Urb, Urb, Urb, Urb, Urb, Urb, Urb, Urb, Urb, Chw, Urb, Urb, Urb, Urb, Urb, Urb, Urb
Dd, Dd, Wwt, Wwt, Wwt, Wot, Wot, Wwt, Wwt, Wwt, Wwt, Dd, Dd, Dd^Vdt, Dd, Dd, Uue^Em, Uue, Xue, Xue, Uue^Emf, Uue, Uue, Ur, Uue^Emf, Uue, Xue, Xue^Qhh, Xoa^Efs, Urb, Urb, Urb, Chw, Urb, Urb, Urb, Urb, Chw, Chw, Chw, Urb, Urb, Urb, Urb, Chw, Urb
Dd, Dd, Wwt, Wwt, Wot, Wot, Wwt, Wwt, Wwt, Wwt, Dd, Dd, Dd^Es, Dd, Dd, Uue^Es, Uue^Em, Uue^Em, Xue, Xue, Uue^Tf, Uue, Uue, Ur, Uue, Uue^Emf, Xue, Xue^Qhh, Xoa^Efs, Urb, Urb, Urb, Urb, Urb, Urb, Urb, Urb, Chw, Chw, Chw, Urb, Urb, Urb, Urb, Urb, Urb
Wwt, Wwt, Wwt, Wwt, Wot, Wot, Wwt, Wwt, Wwt, Wwt, Dd, Dd, Dd^Es, Dd, Dd, Uue^Es, Uue^Es, Uue^Em, Xue, Xue, Uue, Uue, Uue, Ur, Uue^Es, Uue, Xue, Xue^Qhh, Xoa^Efs, Urb, Urb, Urb, Urb, Urb, Urb, Urb, Urb, Urb, Urb, Urb, Urb, Urb, Urb, Urb, Urb, Urb
Wwt, Wwt, Wwt, Wwt, Wwt, Wwt, Wwt, Wwt, Wwt, Dd, Dd, Dd, Dd^Es, Dd, Uue, Uue, Uue, Uue, Xu, Xue, Uue, Uue, Uue, Urb^Vhcr, Uue, Uue^Es, Xue, Xue^Qhh, Xoa^Efs, Urb, Urb, Urb^Vhcr, Urb, Urb, Chw, Urb, Urb, Urb, Urb, Urb, Urb, Urb, Chw, Urb, Urb, Urb^Vhcr
Wwt, Wwt, Wot, Wot, Wwt, Wwt, Wwt, Wwt, Dd, Dd, Dd, Dd^Dr, Dd^Es, Dd, Uue, Uue, Xue, Xue, Xue, Xue, Uue^Es, Uue^Es, Urb, Urb, Urb, Uue^Es, Uue^Emf, Xue^Qhh, Xoa^Qhh, Urb, Urb, Urb, Urb, Urb, Urb, Urb, Urb, Chw, 2 Khw, Chw, Urb, Urb, Urb, Urb, Urb, Urb
Wot, Wwt, Wwt, Wwt, Wwt, Wwt, Wwt, Dd, Dd, Dd, Dd, Dd, Dd, Dd, Dd, Uue, Xue, Xue, Xue, Xue, Uue^Es, Uue^Em, Urb, Uue, Uue, Urb, Urb, Uue^Qhh, Urb, Xoa, Xoa^Efs, Urb, Urb, Urb, Urb, Urb, Urb, Urb, Urb, Urb, Urb, Urb, Urb, Urb, Urb, Urb
Wot, Wot, Wwt, Wwt, Dd, Wwt, Dd, Dd, Dd, Dd^Vdt, Dd^Es, Dd^Es, Dd, Dd, Uue, Uue^Emf, Uue^Emf, Xue, Xue, Uue, Uue^Em, Uue^Em, Urb, Uue, Uue^Es, Uue, Uue^Emf, Urb^Qhh, Urb, Urb, Urb, Xoa^Efs, Xoa^Efs, Urb, Urb, Urb^Vhcr, Urb, Urb, Urb, Urb, Urb, Urb^Vhcr, Urb, Urb, Xoa^Efs, Xoa^Efs
Wwt, Wwt, Wwt, Dd, Dd, Dd, Dd, Dd^Es, Dd, Dd, Dd, Dd, Dd, Dd, Dd, Uue^Emf, Uue, Xue, Xue, Uue, Uue, Uue, Chr, Uue, Uue, Uue, Uue, Uue^Qhh, Xoa^Qhh, Urb, Urb, Urb^_mh, Urb, Xoa^Efs, Xoa^Efs, Urb, Urb, Urb, Urb, Urb, Urb, Urb, Xoa^Efs, Xoa^Efs, Urb^Dr, Xue
Wwt, Wwt, Dd, Dd, Dd^Es, Dd^Dr, Dd, Dd, Dd, Dd, Cer, Cer, Cer, Dd, Uue^Em, Uue, Xue, Xue, Xue, Uue, Uue, Chr, 3 Khr, Chr, Uue^Emf, Uue, Xue, Xue, Xue^Qhh, Xoa^Efs, Xoa^Efs, Urb, Urb, Urb, Urb, Xoa^Efs, Urb, Urb, Urb, Urb, Urb, Xoa^Efs, Urb, Urb, Urb^Dr, Xue
Wwt, Wwt, Dd^Es, Dd^Es, Dd, Dd, Dd, Uue, Uue, Uue, Cer, 1 Kerg, Cer, Uue, Uue, Uue^Em, Uue, Xue, Xue, Uue, Uue, Chr, Chr, Chr, Uue, Uue^Emf, Xue, Xue, Xue^Qhh, Xue, Xue, Xoa^Efs, Xoa^Efs, Urb, Urb, Urb, Urb, Urb, Urb^Vhcr, Urb, Urb, Urb, Urb, Urb, Xos^Efs, Xos^Efs
Wwt, Dd, Dd, Dd, Dd, Uue, Uue^Emf, Uue, Uue^Em, Uue, Uue^Emf, Cer, Uue, Uue, Uue, Uue, Uue, Xue, Xue, Uue^Emf, Uue^Emf, Uue, Uue, Uue, Uue^Emf, Uue^Emf, Xue, Xue, Xue^Qhh, Xue, Xue, Xue, Xue, Xoa^Efs, Xoa^Efs, Urb, Urb, Urb, Urb, Urb, Urb, Urb, Xos^Efs, Xos^Efs, Xue, Xue
Dd, Dd, Dd, Dd^Vdt, Dd, Uue, Uue, Uue, Uue^Em, Uue, Uue, Uue, Uue, Uue^Emf, Xue, Xue, Xue, Xue, Xue, Xue, Xue, Uue, Uue, Uue^Emf, Xue, Xue, Xue, Xue, Xue^Qhh, Xue, Xue, Xue, Xue, Xue, Xue, Xoa^Efs, Xoa^Efs, Urb^Dr, Urb^Dr, Urb^Dr, Xos^Efs, Xos^Efs, Xue, Xue, Xue, Xue
Dd, Dd, Dd, Dd, Uue, Uue, Xue, Xue, Xue, Xue, Xue, Uue, Uue, Uue, Xue, Xue, Xue, Xue, Xu, Xue, Xue, Xue, Xue, Xue, Xu, Xu, Xu, Xu, Xu^Qhh, Xue, Xue, Xue, Xue, Xue, Xue, Xue, Xue, Xue, Xue, Xue, Xue, Xue, Xue, Xue, Xue, Xue
