Xue^Qhu, Xue^Qhu, Xue^Qhu, Xue^Qhu, Xue^Qhu, Xue^Qhu, Xue^Qhu, Xue^Qhu, Xue^Qhu, Xue^Qhu, Xue^Qhu, Xue^Qhu, Xue^Qhu, Xue, Xue, Xue, Xue, Xue, Xue, Xue, Xue, Xue, Xue, Xue, Xue, Xue, Xue^Qhh, Xue, Xue^Qhh, Xue, Xue, Xue, Xue, Xue, Xue, Xue, Xue, Xue, Xue, Xue, Xue, Xue, Xue, Xue, Xue, Xu
Xue^Qhu, Uue^Dr, Uue, Uue, Uue, Uue, Uue, Uue, Uue, Uue, Uue, Tb^Tf, Uue^Qhu, Uue, Uue, Uue, Uue, Uue, Uue, Tb^Tf, Tb^Tf, Tb^Tf, Xue, Xue, Xue, Xue^Qhh, Xue^Qhh, Xue^Qhh, Xue, Xue, Xue, Xue, Uue^Emf, Xue, Uue^Es, Tb^Tf, Tb^Tf, Tb^Tf, Uue^Vhcr, Uue^Dr, Uue, Uue, Uue^Emf, Xue, Uue^Dr, Xue
Xue^Qhu, Urb^Dr, Urb, Urb, Urb, Urb, Urb, Urb, Urb, Urb, Urb, Urb, Urb^Qhu, Urb, Urb, Urb, Urb, Uue, Urb, Uue, Uue, Tb^Tf, Uue, Xue, Xue, Xue, Xue^Qhh, Xue, Xue, Xue, Xue, Uue^Dr, Uue, Uue, Urb, Urb, Urb, Uue, Urb, Uue^Dr, Urb, Urb, Urb, Uue^Emf, Uue^Dr, Xue
Xue^Qhu, Urb^Dr, Uue, Urb^Em, Uue^Em, Urb, Urb, Urb, Urb, Urb^_ml, Uue, Urb, Uue^Qhu, Urb^Es, Uue, Urb, Urb, Urb, Urb, Urb, Urb, Urb, Uue^Em, Uue, Xue, Xue, Xue^Qhh, Xue, Tb^Tf, Tb^Tf, Uue, Uue, Urb, Urb, Urb, Urb, Urb, Urb, Urb, Urb, Urb, Urb, Urb, Urb, Urb^Dr, Xue
Xu^Qhu, Uue^Dr, Xue^Qhu, Uue^Qhu, Xue^Qhu, Uue, Uue^Qhu, Urb, Uue^Qhu, Uue, Xue^Qhu, Uue, Xue^Qhu, Uue^Es, Tb^Tf, Uue^Es, Tb^Tf, Urb, Uue, Urb, Urb, Urb, Urb, Uue^Es, Uue^Es, Xue, Xue^Qhh, Xue, Uue, Uue^Emf, Urb, Urb, Urb, Urb, Uue^Dr, Uue^Em, Uue, Urb^_mh, Urb, Urb, Uue^Es, Uue^Em, Uue, Urb^Dr, Xue, Xue
Xu^Qhu, Xue^Qhu, Xue, Xue^Qhu, Xue, Xue^Qhu, Uue, Urb^Qhu, Uue, Xue^Qhu, Uue, Xue^Qhu, Xue, Xue, Xue, Tb^Tf, Tb^Tf, Uue^Em, Uue^Vhcr, Uue, Urb, Urb, Urb, Uue, Uue, Xue, Xue^Qhh, Xue, Uue, Urb, Urb, Urb, Uue, Uue^Dr, Xue, Uue^Tf, Uue, Uue, Urb, Uue, Uue, Uue^Tf, Xue, Uue^Dr, Xue, Xue
Xue, Xue, Xue, Xue, Uue^Em, Uue^Em, Uue^Es, Uue^Es, Uue^Es, Uue^Em, Uue^Em, Uue^Em, Uue, Xue, Xue, Xue, Xue, Uue, Uue, Uue, Urb, Urb, Urb, Uue^Tf, Uue^Dr, Uue, Xue^Qhh, Uue^Dr, Uue, Urb, Urb, Uue, Uue^Emf, Xue, Xue, Xoa^Efs, Uu, Chw, Urb, Chw, Uu, Xoa^Efs, Xue, Xue, Xue, Xue
Xue, Xue, Uue, Uue^Em, Dd, Uue, Dd, Dd^Es, Dd^Es, Dd, Dd^Es, Dd, Dd, Uue, Xue, Xue, Xue, Xue, Xue, Tb^Tf, Tb^Tf, Urb, Urb, Urb, Urb, Uue, Tb^Tf, Xue^Qhh, Uue^Qhh, Urb, Urb, Uue, Uue^Emf, Xue, Xue, Xoa^Efs, Uu, Uu, Urb, Uu, Uu, Xoa^Efs, Xue, Xue, Xue, Xue
Xue, Uue, Uue, Dd, Dd^Vdt, Dd, Dd, Dd, Dd, Dd^Es, Dd, Dd^Es, Dd^Es, Uue, Uue, Uue, Uue, Xue, Xue, Tb^Tf, Uue^Em, Uue, Uue, Urb, Urb, Urb, Urb^Dr, Uue^Dr, Urb^Dr, Urb^Qhh, Urb^Qhh, Uue, Uue, Xue, Xue, Xoa^Efs, Uu, Urb, Urb, Urb, Uu, Xoa^Efs, Xue, Xue, Xue, Xue
Uue, Uue, Dd, Dd, Dd, Dd, Dd, Dd, Dd, Dd, Dd, Dd^Dr, Dd, Dd, Dd, Dd, Uue, Xue, Xue, Xue, Xue, Uue^Em, Tb^Tf, Uue^Dr, Uue, Urb, Urb, Urb, Urb, Urb, Uue^Es, Uue^Qhh, Uue^Qhh, Xue, Xue, Xoa^Efs, Uu, Urb, Urb^Dr, Urb^Dr, Uu, Xoa^Efs, Xue, Xue, Xue, Xue
Dd, Dd, Dd^Es, Dd, Wwt, Dd, Wwt, Dd, Wwt, Dd, Dd, Dd, Dd, Dd^Es, Dd^Es, Dd, Dd, Uue, Uue^Emf, Xue, Xue, Xue, Xue, Tb^Tf, Uue^Dr, Urb, Urb, Uue^Dr, Uue^Dr, Tb^Tf, Uue, Uue^Vhcr, Tb^Tf, Xue^Qhh, Xue^Qhh, Xoa^Efs, Uu, Urb, Urb, Urb, Uu, Xoa^Efs, Xue, Xue, Xue, Xue
Dd, Dd^Es, Dd, Dd, Wwt, Wwt, Wwt, Wwt, Wwt, Wwt, Wwt, Wwt, Wwt, Dd, Dd, Dd^Es, Dd, Dd, Uue, Uue^Emf, Xue, Xue, Xue, Uue^Dr, Uue^Dr, Tb^Tf, Urb, Urb, Uue, Xue, Xue, Tb^Tf, Xue, Xue, Xue^Qhh, Xoa^Efs, Uu, Urb^Dr, Urb, Urb, Uu, Xoa^Efs, Xue, Xue, Xue, Xue
Dd^Es, Dd^Es, Dd, Wwt, Wwt, Wwt, Wot, Wwt, Wot, Wwt, Wwt, Wwt, Wwt, Dd, Dd, Dd, Dd^Vdt, Dd^Es, Dd, Uue^Emf, Uue, Xue, Xue, Xue, Uue, Urb^Dr, Urb, Uue, Uue, Uue^Emf, Xue, Xue, Xue^Qhh, Xue^Qhh, Xoa^Efs, Xoa^Efs, Uu, Urb, Urb, Urb, Uu, Xoa^Efs, Xoa^Efs, Xue, Xue, Xue
Dd, Dd, Wwt, Wwt, Wwt, Wwt, Wot, Wot, Wot, Wot, Wwt, Wwt, Wwt, Wwt, Wwt, Dd, Dd, Dd, Dd^Es, Uue, Uue^Em, Xue, Xue, Uue, Urb, Urb, Uue, Uue, Xue, Xue, Xue^Qhh, Xue^Qhh, Xoa^Efs, Xoa^Efs, Uu^Dr, Uu^Dr, Urb^Dr, Urb, Uu, Urb, Urb, Uu, Uu, Xoa^Efs, Xoa^Efs, Xue
Dd, Dd, Dd, Wwt, Wwt, Wot, Wot, Wot, Wot, Wot, Wot, Wwt, Wwt, Wwt, Dd, Dd, Dd^Es, Dd, Dd^Es, Uue^Em, Uue, Xue, Xue, Uue, Urb^Vhcr, Uue, Xue, Xue, Xue^Qhh, Xue^Qhh, Xoa^Efs, Xoa^Efs, Uu, Uu, Urb, Urb^Vhcr, Urb, Urb, Uu, Urb, Urb^Dr, Urb^Vhcr, Urb^Dr, Uu^Dr, Uu, Xoa^Efs
Dd, Dd, Wwt, Wwt, Wwt, Wot, Wot, Wot, Wot, Wwt, Wwt, Wwt, Wwt, Wwt, Dd, Dd, Dd^Es, Dd^Es, Uue^Es, Uue^Em, Xue, Xue, Xue, Uue, Ur, Uue^Emf, Xue, Xue^Qhh, Xos^Qhh, Xoa^Efs, Uu, Uu, Urb, Urb, Uu, Urb, Urb^Dr, Uu, Chw, Uu, Urb, Urb^Dr, Uu, Urb, Urb, Uu
Dd, Dd, Dd, Wwt, Wwt, Wwt, Wot, Wot, Wwt, Wwt, Wwt, Wwt, Wwt, Dd, Dd^Dr, Dd, Dd, Dd, Uue, Uue, Xue, Xue, Uue, Uue, Ur, Uue, Xue, Xue^Qhh, Xoa^Qhh, Uu, Urb, Urb, Urb, Uu, Chw, Uu^Dr, Urb, Urb, Uu, Urb, Urb, Uu, Chw, Uu, Urb, Urb
Dd, Dd, Dd, Wwt, Wwt, Wot, Wot, Wot, Wwt, Wwt, Wwt, Dd, Dd, Dd, Dd^Es, Dd, Uue^Tf, Uue, Xue, Xue, Xue, Xue, Uue, Ur^Dr, Uue^Es, Uue^Es, Xue, Xue^Qhh, Xoa^Efs, Uu, Urb, Urb^Vhcr, Urb, Urb, Urb, Urb, Urb, Urb, Uu, Urb, Urb, Urb, Urb, Urb, Urb, Urb^Vhcr
Dd, Dd^Vdt, Dd, Wwt, Wwt, Wwt, Wot, Wot, Wwt, Wwt, Dd, Dd, Dd^Es, Dd, Dd, Dd, Uue, Uue, Xue, Xue, Uue^Emf, Uue^Emf, Tb^Tf, Ur, Uue, Uue^Tf, Xue, Xue^Qhh, Xoa^Efs, Uu, Urb, Urb, Urb, Urb, Uu, Urb, Uu, Uu, Chw, Uu, Uu, Urb, Uu, Urb, Urb, Urb
Dd, Dd, Wwt, Wwt, Wwt, Wot, Wot, Wwt, Wwt, Wwt, Wwt, Dd, Dd, Dd^Vdt, Dd, Dd, Uue^Em, Uue, Xue, Xue, Uue^Emf, Tb^Tf, Uue, Tb^Tf, Uue^Emf, Uue, Xue, Xue^Qhh, Xoa^Efs, Uu, Urb, Urb^Dr, Chw^Dr, Uu^Dr, Uu, Urb, Urb, Chw, Chw, Chw, Urb, Urb, Uu, Uu, Chw, Urb
Dd, Dd, Wwt, Wwt, Wot, Wot, Wwt, Wwt, Wwt, Wwt, Dd, Dd, Dd^Es, Dd, Dd, Uue^Es, Uue^Em, Uue^Em, Xue, Xue, Uue^Tf, Uue, Uue, Ur, Uue, Uue^Emf, Xue, Xue^Qhh, Xoa^Efs, Uu, Urb, Urb, Urb, Uu^Dr, Uu, Urb, Uu, Chw, Chw, Chw, Uu, Urb^Dr, Uu^Dr, Uu, Urb, Urb
Wwt, Wwt, Wwt, Wwt, Wot, Wot, Wwt, Wwt, Wwt, Wwt, Dd, Dd, Dd^Es, Dd, Dd, Uue^Es, Uue^Es, Uue^Em, Xue, Xue, Uue, Uue, Uue, Ur^Dr, Uue^Es, Uue, Xue, Xue^Qhh, Xoa^Efs, Uu, Urb, Urb, Urb, Urb, Urb, Urb, Urb, Uu, Uu, Uu, Urb^Dr, Urb^Dr, Urb, Urb, Urb, Urb
Wwt, Wwt, Wwt, Wwt, Wwt, Wwt, Wwt, Wwt, Wwt, Dd, Dd, Dd, Dd^Es, Dd, Uue, Uue, Uue, Uue, Xu, Xue, Uue, Uue, Uue, Urb^Vhcr, Uue, Uue^Es, Xue, Xue^Qhh, Xoa^Efs, Uu, Urb, Urb^Vhcr, Urb, Urb, Chw, Urb, Urb, Urb, Uu, Urb, Urb, Urb, Chw, Urb, Urb, Urb^Vhcr
Wwt, Wwt, Wot, Wot, Wwt, Wwt, Wwt, Wwt, Dd, Dd, Dd, Dd^Dr, Dd^Es, Dd, Uue, Uue, Xue, Xue, Xue, Xue, Tb^Tf, Uue^Es, Urb, Urb, Urb, Uue^Es, Uue^Emf, Xue^Qhh, Xoa^Qhh, Uu, Uu^Dr, Urb, Urb^Dr, Urb, Urb, Urb, Uu, Chw, 2 Khw, Chw, Uu, Urb, Urb, Urb, Urb, Urb
Wot, Wwt, Wwt, Wwt, Wwt, Wwt, Wwt, Dd, Dd, Dd, Dd, Dd, Dd, Dd, Dd, Uue, Xue, Xue, Xue, Xue, Uue^Es, Uue^Em, Urb, Uue, Uue, Urb, Urb, Uu^Qhh, Uu^Dr, Xoa, Xoa^Efs, Uu^Dr, Uu^Dr, Urb^Dr, Urb, Urb, Urb, Uu, Uu, Uu, Urb, Urb, Urb, Urb, Uu, Uu
Wot, Wot, Wwt, Wwt, Dd, Wwt, Dd, Dd, Dd, Dd^Vdt, Dd^Es, Dd^Es, Dd, Dd, Uue, Uue^Emf, Uue^Emf, Xue, Xue, Uue, Uue^Dr, Uue^Em, Urb, Tb^Tf, Tb^Tf, Uue, Uue^Emf, Urb^Qhh, Urb, Uu^Dr, Uu, Xoa^Efs, Xoa^Efs, Uu, Uu, Urb^Vhcr, Urb, Urb, Uu, Urb, Urb, Urb^Vhcr, Uu, Uu, Xoa^Efs, Xoa^Efs
Wwt, Wwt, Wwt, Dd, Dd, Dd, Dd, Dd^Es, Dd, Dd, Dd, Dd, Dd, Dd, Dd, Uue^Emf, Uue, Xue, Xue, Uue, Uue^Dr, Uue^Dr, Chr, Uue, Uue, Uue, Uue, Uu^Qhh, Xoa^Qhh, Urb, Urb, Uu^_mh, Uu, Xoa^Efs, Xoa^Efs, Uu, Uu, Urb, Urb^Dr, Urb^Dr, Uu^Dr, Uu, Xoa^Efs, Xoa^Efs, Uu^Dr, Xue
Wwt, Wwt, Dd, Dd, Dd^Es, Dd^Dr, Dd, Dd, Dd, Dd, Cer, Cer, Cer, Dd, Uue^Em, Uue, Xue, Xue, Xue, Uue, Uue^Dr, Chr^Dr, 3 Khr, Chr, Uue^Emf, Uue, Xue, Xue, Xue^Qhh, Xoa^Efs, Xoa^Efs, Urb, Urb, Uu, Uu^Dr, Xoa^Efs, Uu, Urb, Urb, Urb, Uu, Xoa^Efs, Uu, Uu, Uu^Dr, Xue
Wwt, Wwt, Dd^Es, Dd^Es, Dd, Dd, Dd, Uue, Uue, Uue, Cer, 1 Kerg, Cer, Uue, Uue, Uue^Em, Uue, Xue, Xue, Tb^Tf, Uue, Chr, Chr, Chr, Uue, Uue^Emf, Xue, Xue, Xue^Qhh, Xue, Xue, Xoa^Efs, Xoa^Efs, Urb^Dr, Urb, Uu^Dr, Urb, Urb, Urb^Vhcr, Urb, Urb, Uu, Urb, Urb, Xos^Efs, Xos^Efs
Wwt, Dd, Dd, Dd, Dd, Uue, Uue^Emf, Uue, Uue^Em, Uue, Uue^Emf, Cer, Uue, Uue, Uue, Uue, Uue, Xue, Xue, Uue^Emf, Uue^Emf, Uue, Uue, Uue, Tb^Tf, Uue^Emf, Xue, Xue, Xue^Qhh, Xue, Xue, Xue, Xue, Xoa^Efs, Xoa^Efs, Urb, Uu, Uu, Uu, Uu, Uu, Urb, Xos^Efs, Xos^Efs, Xue, Xue
Dd, Dd, Dd, Dd^Vdt, Dd, Uue, Uue, Uue, Uue^Em, Uue, Uue, Uue, Uue, Uue^Emf, Xue, Xue, Xue, Xue, Xue, Xue, Xue, Uue, Uue, Uue^Emf, Xue, Xue, Xue, Xue, Xue^Qhh, Xue, Xue, Xue, Xue, Xue, Xue, Xoa^Efs, Xoa^Efs, Uu^Dr, Uu^Dr, Uu^Dr, Xos^Efs, Xos^Efs, Xue, Xue, Xue, Xue
Dd, Dd, Dd, Dd, Uue, Uue, Xue, Xue, Xue, Xue, Xue, Uue, Uue, Uue, Xue, Xue, Xue, Xue, Xu, Xue, Xue, Xue, Xue, Xue, Xu, Xu, Xu, Xu, Xu^Qhh, Xue, Xue, Xue, Xue, Xue, Xue, Xue, Xue, Xue, Xue, Xue, Xue, Xue, Xue, Xue, Xue, Xue
