border_size=1
usage=map

Gg, Gll^Ftr, Gll^Ftr, Ss, Ss, Wwt, Gs, Gs, Gs^Fds, Gs^Fds, Gs^Fds, Gs^Fmw, Gs^Fds, Gg, Gs^Fmw, Gg, Gg, Gg, Gg, Gg, Hh^Fds, Gs^Fmf, Gs^Fds, Gs^Ft, Gs^Ft, Gs^Ft, Ww, Ww
Gll^Ftr, Gll^Ftr, Gs^Fmw, Gll^Ftr, Gs^Fmw, Ww, Gs, Gs^Fms, Gs^Fmw, Gs^Fmw, Gs^Fds, Hh^Vd, Hh^Fds, Gs^Fds, Gs^Fds, Gs^Fds, Gs^Fds, Gg, Gg, Gs^Fp, Hh^Fds, Gs^Fds, Gs^Fds, Gs^Fds, Ss, Gs^Ft, Ww, Ds
Gll^Ftr, Gll^Ftr, Gs^Ft, Gs^Ft, Gs^Ft, Ww, Ww^Bsb/, Gs, Gs, Gs^Fds, Gs^Fmw, Hh^Fds, Hh^Fds, Gs^Fds, Gs^Fds, Gs^Fds, Hh^Fds, Hh^Fds, Gs^Fds, Hh^Fds, Mm, Mm, Hh^Fp, Hh^Fp, Hh^Fp, Ss, Hh^Fp, Gs^Ft
Gll^Ftr, Gll^Ftr, Gs, Gs^Fmw, Gs^Fmw, Gs, Gs^Ft, Ww, Ww, Ss, Ss, Gs^Fds, Gs^Fds, Gs^Fds, Gg^Efm, Gg^Fet, Rp, Hh^Fp, Hh, Hh^Fp, Rp, Rp, Rp, Mm, Hh^Fp, Ss, Hh^Fp, Hh^Fp
Gs, Gd^Fts, Gs, Gs, Gs, Gs, Hh^Ftp, Gs^Ft, Gs^Ft, Ww, Ww, Hh^Fds, Hh^Fds, Gg^Efm, Gg^Efm, Gg^Efm, Rp, Hh^Fp, Mm, Rp, Ch, Ch, Ch, Rp^Fet, Mm, Mm, Mm, Hh^Fp
Gs, Gs, Gs, Gd^Fts, Hh^Ftp, Hh^Ftp, Mm^Vd, Hh^Ftp, Hh^Ftp, Gs^Ft, Gs^Ft, Ww, Hh^Fds, Gg^Efm, Hh^Fds, Gg^Efm, Rp, Rp, Rp, Rp, Ch, Kh, Ch, Rp, Mm, Mm^Vd, Mm, Hh^Fp
Gs^Ft, Gs^Ft, Hh^Ftp, Hh^Ftp, Mm, Mm, Uh, Mm, Mm, Hh^Ftp, Hh^Ftp, Ww, Ww, Hh^Fds, Mm, Rp, Rp, Rp, 1 Rp, Rp, 2 Rp, Ch, Rp, Rp, Mm, Mm, Mm, Hh^Fp
Gg^Ftp, Hh^Ftp, Mm, Mm, Uh, Uh, Qlf, Uh, Uh, Mm, Mm, Hh^Fds, Ww, Hh^Fds, Hh^Fds, Mm, Mm, Mm, Rp, Rp, Rp, Rp, Rp, Rp, Mm, Mm, Mm, Hh^Fp
Gs^Ft, Hh^Ftp, Mm, Uh, Qlf, Qlf, Mv, Qlf, Qlf, Uh, Mm, Hh^Fds, Hh^Fds, Ww, Hh^Fds, Mm, Mm, Rp^Vd, Rp, Rp, Rp, Rp, Mm, Mm, Mm, Hh^Fp, Hh^Fp, Hh^Fp
Mm, Mm, Uh, Uh, Qlf, Mm, Mm, Mm, Qlf, Uh, Mm, Mm, Mm, Ww, Hh^Fds, Mm, Mm, Mm, Mm, Rp, Rp, Rp, Rp, Mm, Mm, Hh^Fp, Gs, Gs
Mm, Mm, Uh, Qlf, Qlf, Qlf, Qlf, Qlf, Qlf, Uh, Uh, Mm, Mm, Ww, Ww, Hh^Fds, Hh^Fds, Mm, Mm, Rp, Rp, Rp, Rp^Fet, Mm, Hh^Fp, Hh^Fp, Gs, Gs^Ftp
Hh^Fds, Mm, Mm, Uh, Uh, Uh, Uh, Qlf, Uh, Qlf, Uh, Mm, Mm, Hh^Fds, Ww, Ww, Hh^Fds, Mm, Mm, Mm, Mm, Rp^Vd, Mm, Gs^Fp, Gs^Fp, Gs, Gs^Ftp, Gs^Ft
Gs, Hh^Fds, Hh^Vd, Mm, Mm, Mm, Mm, Uh, Mm, Uh, Mm, Mm, Mm, Hh^Fds, Mm, Ww, Ww, Hh^Fds, Mm, Mm^Xm, Mm, Mm, Hh^Fp, Hh^Fp, Gs, Gs, Gg, Gs
Gs, Gs, Gs, Hh^Fds, Hh^Fds, Mm, Mm, Mm, Mm, Mm, Mm, Mm, Mm, Mm, Hh^Fds, Hh^Fds, Ww, Hh^Fds, Mm, Mv, Mm, Mm, Hh^Ft, Gs, Gs^Ft, Gs^Ftp, Gs^Ft, Gs^Ft
Gll^Ftr, Gll^Ftr, Gll^Ftr, Gs, Gll^Ftr, Hh^Fds, Hh^Fds, Mm, Hh^Fds, Hh^Fds, Gs^Ft, Hh^Fds, Hh^Fds, Hh^Fds, Hh^Fds, Gs^Fds, Ww, Hh^Ft, Mm, Mm, Mm, Hh^Ft, Hh^Ft, Gs, Gs^Ft, Gs^Ftp, Gs^Ft, Gs^Ft
Gll^Ftr, Gll^Ftr, Gll^Ftr, Gll^Ftr, Gll^Ftr, Gll^Ftr, Gll^Ftr, Hh^Fds, Gll^Ftr, Gll^Ftr, Gs^Ft, Gs^Ft, Gll^Ftr, Hh^Fds, Hh^Fds, Ww, Gs^Ft, Hh^Ft, Mm, Mm^Xm, Mm, Hh^Ft, Gs^Ft, Gs^Ft, Gs^Ft, Gs^Ft, Gs^Ft, Gs^Ft
Gll^Ftr, Gs^Ft, Ss, Ss, Ss, Gll^Ftr, Ss, Gll^Ftr, Gll^Ftr, Ss, Gll^Ftr, Gll^Ftr, Gll^Vd, Gll^Ftr, Gll^Ftr, Ww, Gs^Ft, Hh^Ft, Mm, Mm, Mm, Gs^Ft, Gs^Ftp, Ss, Gs^Ftp, Gs^Ft, Gs^Ft, Gs^Ft
Gll^Ftr, Ss, Ss, Ss, Ss, Ss, Ss, Ss, Ss, Ss, Ss, Gll^Ftr, Gll^Ftr, Gll^Ftr, Ww, Ww, Hh^Ft, Hh^Ft, Mm, Mm, Hh^Ft, Gs^Ftp, Gs^Ftp, Ss, Gs^Ftp, Gs^Vd, Gs^Ftp, Gs^Ft
Gs^Ft, Ss, Ss, Ss, Ww^Ewl, Ss, Ww, Ww^Ewl, Ww, Ww^Ewl, Ww, Gll^Ftr, Wwt, Ww, Gs^Ft, Hh^Ft, Mm, Mm, Mm, Hh^Ft, Gs^Ft, Gs^Ftp, Gs^Ftp, Ss, Gs^Ftp, Gs^Ftp, Gs^Ftp, Gs^Ftp
Ss, Ss, Ss, Ss, Ww, Ww, Gs, Wwt, Gs^Ft, Wwt, Gs^Ft, Wwt, Gs^Ft, Gs^Ft, Hh^Ft, Hh^Ft, Mm, Mm, Hh^Ft, Hh^Ft, Gs^Ftp, Gs^Ftp, Gs^Ftp, Ss, Gs^Ftp, Gs^Ftp, Gs^Ftp, Gs^Ftp
Ss, Ss, Ss, Ww, Ww, Gs, Gs^Ft, Gs^Ft, Gs^Ft, Gs^Ft, Gs^Ft, Gs^Ft, Hh^Ft, Hh^Ft, Mm, Mm, Hh^Ft, Hh^Ft, Gs^Ft, Gs^Ft, Gs^Ftp, Gs^Ftp, Gs^Ftp, Ss, Ss, Gs^Ftp, Gs^Ftp, Wwf
