Wot, Wot, Wot, Wot, Wot, Wwt, Wot, Wot, Wot, Wwt, Wot, Wot, Wot, Wot, Wot, Wot, Wwt, Wwt, Wwt, Wwt, Ww, Ww, Ww, Ds, Ds, Gs, Gs, Gs^Ftp, Gs^Ftp, Gs^Ftp, Gs, Gs, Rd, Gs, Gd, Gd, Hhd, Hhd, Md, Md
Wot, Wot, Wot, Wot, Wot, Wot, Wot, Wot, Wwt, Wot, Wwt, Wot, Wwt, Wwt, Wwt, Wwt, Ww, Wwt, Ww, Ww, Ww, Ww, Ds, Ds, Gs^Ftp, Gs^Ftp, Gs^Ftp, Gs, Gd, Gd, Rd, Rd, Gd, Gd, Hhd, Hhd^Ftp, Hhd, Md, Hhd, Hhd
Wot, Wot, Wot, Wot, Wwt, Wwt, Wwt, Wwt, Wwt, Wwt, Ww, Wwt, Ww, Wwt, Ww, Ww, Ww, Ww, Ww, Ww, Ds, Ds, Gs, Gs^Ftp, Gs^Ftp, Gs^Ftp, Gd, Gd, Rd, Rd, Hhd^Ftp, Hhd, Dd^Qhu, Dd^Qhu, Dd^Qhu, Hd^Qhu, Dd^Qhu, Hd^Qhu, Dd^Qhu, Dd^Qhu
Wwt, Wwt, Wwt, Wwt, Wwt, Wwt, Ww, Wwt, Ww, Ww, Ww, Ww, Ww, Ww, Ww, Ww, Ds, Ds, Ds, Ds, Gs^Ftp, Gs, Gs^Ftp, Gs^Ftp, Gd, Gd^Vc, Rd, Rd, Dd^Qhu, Hhd, Dd^Qhu, Dd^Qhu, Hd, Dd^Qhu, Hd, Hd, Dd^Vdt, Hd, Dd^Qhu, Hhd
Ww, Wwt, Ww, Ww, Ww, Ww, Ww, Ww, Ww, Ww, Ww, Ww, Ww, Ww, Ds, Ds, Gs, Gs, Gs^Ftp, Gs^Ftp, Gd^Vc, Gd, Rd, Gd, Rd, Rd, Gd^Ftp, Gd, Dd^Qhu, Dd^Qhu, Hd, Hd, Dd^Qhu, Hd^_ml, Dd^Qhu, Dd^Qhu, Hd^Qhu, Dd^Qhu, Hhd, Hhd
Ww, Ww, Ww, Ww, Ww, Ww, Ww, Ww, Ds, Ww, Ds, Ds, Ds, Ds, Gs^Ftp, Gs^Ftp, Gs^Ftp, Gs^Ftp, Gs^Ftp, Gd, Rd, Rd, Gd, Rd, Gd, Gd^Ftp, Hhd, Dd^Qhu, Hhd, Dd^Qhu, Dd^Qhu, Dd^Qhu, Dd, Dd^Qhu, Hhd, Hhd, Hhd^Ftp, Hhd, Md, Md
Ds, Ww, Ds, Ww, Ww, Ww, Ww, Ds, Gs^Ftp, Ds, Gs^Ftp, Gs^Ftp, Gs^Ftp, Gs, Rd, Gs^Ftp, Rd, Rd, Rd, Rd, Hhd^Ftp, Gd, Hhd, Hhd, Hhd, Dd^Qhu, Dd^Qhu, Hhd, Dd^Qhu, Dd^Qhu, Dd, Dd^Vdt, Dd, Hhd, Hhd, Hhd, Gd, Hhd, Md, Md
Gs, Ds, Gs, Ds, Gs^Ftp, Ww, Ww, Ds, Gs^Ftp, Gs^Ftp, Gs^Vc, Gs, Rd, Rd, Hhd, Rd, Hhd^Ftp, Hhd, Gd, Hhd, Hhd, Hhd^Ftp, Hhd, Dd^Qhu, Dd^Qhu, Dd^Qhu, Dd, Dd^Qhu, Ce, Ce, Ce, Dd, Dd, Dd^Es, Hhd, Gd, Gd, Hhd, Hhd, Hhd
Gs^Ftp, Gs, Gs^Ftp, Gs^Ftp, Gs^Ftp, Ww, Ww, Ww, Rd, Gs^Ftp, Rd, Rd, Gd, Gd, Gd, Hhd, Gd, Hhd, Dd^Qhu, Dd^Qhu, Dd^Qhu, Hhd, Hhd, Dd^Qhu, Dd^Qhu, Dd^Es, Dd^Vdt, Dd, Ce, 4 Ke, Ce, Dd^Ftd, Dd, Hhd, Hhd, Gd, Hhd, Gd, Gd, Gd
Gs^Ftp, Gs, Gd, Gs^Ftp, Gd, Gs, Rd, Ww^Bw/, Ww, Rd, Gd, Gs, Ww^Ewl, Gd, Gs^Ftp, Gs, Gs^Ftp, Gd, Gd, Dd^Qhu, Dd^Qhu, Hhd, Md, Hhd, Dd^Qhu, Dd^Ftd, Dd, Dd, Dd^Ftd, Ce, Dd, Dd^_ml, Hd, Dd, Dd, Dd, Dd, Hhd, Hhd, Hhd
Gd, Gd, Rd, Gd, Rd, Rd, Gs, Ww, Ww, Ww, Ww, Ww^Ewl, Ww, Ss, Ww, Ss, Ss, Gs, Gs^Ftp, Gd, Gd, Hhd, Md, Hhd, Hd^Qhu, Dd, Dd^Ftd, Dd, Dd^Ftd, Dd, Dd^Es, Dd^Es, Dd^Vdt, Dd, Dd^Vdt, Dd, Hhd, Hhd, Md, Md
Rd, Rd, Gd, Rd, 1 Gd, Gd, Gd, Gs, Gs, Gs, Ss^Qhu, Ww, Ss^Qhu, Ww, Ww^Ewl, Ww, Ww, Ww, Ww, Gs, Gd, Hhd^Ftp, Hhd^Ftp, Md, Hhd, Dd^Qhu, Dd^Qhu, Dd^Qhu, Dd^Qhu, Dd, Hd^Qhu, Dd, Dd, Dd^Ftd, Dd, Dd, Hhd, Md, Md, Hhd
Gd, Gd, Gd^Ftp, Gd, Gd, Gd, Gd, Gs^Ftp, Hhd, Gd, Gs^Ftp, Ss^Qhu, Ss^Vhs, Ss^Qhu, Ss^Qhu, Ss^Qhu, Gs, Gs^Ftp, Ww, Gs^Ftp, Gs, Gd, Hhd, Hhd, Gd, Gd, Gd, Gd, Gd, Hd^Qhu, Md, Hd^Qhu, Dd, Dd^Es, Dd, Dd, Hhd, Hhd, Md, Md
Hhd, Hhd, Hhd, Gd, Gd^Ftp, Gd, Hhd, Hhd, Hhd, Gd, Gd, Ss^Qhu, Ss^Qhu, Ss^_ml, Ss^Qhu, Ss^Qhu, Gd, Gs, Gs^Ftp, Ww, Gs^Ftp, Gd, Gd, Gd, Gs, Gs, Gs^Ftp, Gs, Gs, Hhd, Hhd, Hd^Qhu, Dd, Dd^Vdt, Dd, Hd, Dd^Es, Hd, Md, Md
Hd^Qhu, Hd^Qhu, Hd^Qhu, Hhd^Ftp, Hhd^Ftp, Hhd^Ftp, Md, Md, Hhd, Dd^Qhu, Gd, Gs^Ftp, Ss^Qhu, Ss^Qhu, Gd, Gd, Dd^Qhu, Gd, Gs, Ww, Ww, Gs, Gs^Ftp, Gs, Ww, Ww, Ww, Ww, Ww, Gs, Gd, Hd^Qhu, Dd^Qhu, Dd^Ftd, Hd, Dd, Dd^Es, Hd, Md, Md
Dd^Qhu, Hd^Qhu, Dd^Qhu, Dd^Qhu, Hhd, Md, Md, Hhd^Ftp, Hhd, Dd^Qhu, Dd^Qhu, Gd, Gd, Gd, Dd^Qhu, Dd^Qhu, Dd^Qhu, Gd, Gd, Gs^Ftp, Ww, Ss, Ww, Ss, Ww, Gs, Gs^Ftp, Gs, Ww, Gs^Ftp, Gs, Gd, Dd^Qhu, Dd^Ftd, Hd, Hd, Dd^Ftd, Hd, Md, Md
Dd, Dd, Dd, Dd^Qhu, Dd^Qhu, Hhd, Hhd, Hhd, Gd, Dd^Qhu, Dd, Dd^Qhu, Dd^Qhu, Dd^Qhu, Dd^Ftd, Dd^Ftd, Dd^Ftd, Dd^Qhu, Gd, Gs, Gs^Ftp, Ww, Gs, Ww, Gs^Ftp, Gs^Ftp, Rd, Gs^Ftp, Gs, Ww, Gs^Ftp, Gd, Gd, Dd^Qhu, Hd, Dd^Vdt, Dd, Hd, Md, Md
Dd, Dd, Dd^Vdt, Dd^Qhu, Gd, Hhd, Md, Hhd, Dd^Qhu, Dd^Qhu, Dd^Es, Dd^Vdt, Dd, Dd^Ftd, Dd^Ftd, Dd^Ftd, Dd, Dd^Qhu, Dd^Qhu, Gd, Gd, Gs, Hhd, Gs^Ftp, Ss^Qhu, Ss^Qhu, Ss^Qhu, Rd, Gs^Ftp, Ww, Ww, Gs, Gd, Dd^Qhu, Dd^Qhu, Hd, Dd^Ftd, Hd, Hd, Md
Dd, Dd^Es, Dd^Es, Dd^Qhu, Hhd, Hhd, Md, Hhd, Gd, Dd^Qhu, Dd^Qhu, Dd^Es, Dd, Dd^Es, Dd^Es, Dd^Ftd, Dd, Dd^Vdt, Dd, Dd^Qhu, Gd, Hhd, Hh^Ftp, Hh^Ftp, Ss^Qhu, Ss^Vhs, Ss^Qhu, Rd, Rd, Rd, Ww^Bw\, Gs, Ce, Ce, Ce, Dd^Qhu, Dd^Qhu, Hd, Dd^Qhu, Hd
Dd, Dd, Dd^Qhu, Dd^Qhu, Hhd, Md, Hhd^Ftp, Hhd^Ftp, Gd, Gd, Dd^Qhu, Dd, Dd, Dd^Es, Dd^Es, Dd, Dd^Es, Dd, Dd^Qhu, Dd^Qhu, Hhd, Hhd^Ftp, Hh^Ftp, Ss^Qhu, Ss^_ml, Ss, Ss^Qhu, Hh^Ftp, Gs^Ftp, Ww, Gs, Rd, Ce, 2 Ke, Ce, Dd^Qhu, Gd^Vc, Dd^Qhu, Rd, Hd^Qhu
Dd, Dd^Dc, Dd^Qhu, Gd, Hhd, Hhd^Ftp, Gd^Ftp, Gd, Dd^Qhu, Dd^Qhu, Dd, Dd, Dd, Dd, Dd, Dd, Dd, Dd^Qhu, Hhd, Hhd, Hhd, Hhd, Hh^Ftp, Ss^Qhu, Ss^Qhu, Ss^Qhu, Hh, Hh^Ftp, Gs, Ww, Ww, Gs, Gd, Ce, Gd, Rd, Rd, Rd, Gs^Ftp, Rd
Dd, Dd, Dd, Dd^Qhu, Gd, Hhd^Ftp, Gd, Gd, Dd^Qhu, Dd, Dd^Ftd, Dd^Ftd, Dd, Dd^Es, Dd, Dd^Dc, Dd, Dd^Qhu, Dd^Qhu, Gd, Hhd, Hhd, Md, Hh^Ftp, Gs, Gs, Gs, Gs, Gs^Fms, Gs, Ww, Gs, Gs^Ftp, Gd, Gs^Ftp, Gs, Ww, Gs^Ftp, Ww, Gs
Dd^Es, Dd^Es, Dd, Dd^Qhu, Dd^Qhu, Gd, Dd^Qhu, Dd^Qhu, Dd, Dd^Ftd, Dd, Dd, Dd, Dd^Es, Dd^Es, Dd, Dd, Dd^Ftd, Dd^Qhu, Dd^Qhu, Gd, Hhd, Hhd, Hhd, Gd, Gs^Fms, Gs^Fms, Gs^Fms, Gs^Fms, Gs, Gs, Ww, Gs^Ftp, Gs^Ftp, Gs^Ftp, Ww, Gs^Ftp, Ww, Gs^Ftp, Ww
Dd^Es, Dd^Es, Dd, Dd, Dd, Dd^Qhu, Dd, Dd, Dd^Es, Dd, Dd, Dd, Dd^Vdt, Dd, Dd^Es, Dd^Es, Dd, Dd, Dd^Qhu, Hhd, Hhd, Hhd^Ftp, Gd, Gd, Gd, Gs, Gs^Fms, Gs^Fms, Gd, Gs^Fms, Gs, Ww, Ww, Ww, Ww, Ww, Gs, Gs^Ftp, Gd, Gs
Dd, Dd, Dd, Dd^Vdt, Dd, Dd, Dd, Dd^Es, Dd, Dd^Es, Dd, Dd, Dd, Dd, Dd, Dd, Dd^Es, Dd^Qhu, Hhd, Hhd, Dd^Qhu, Hhd, Hhd, Gd, Hhd, Gd, Gd, Gd, Hhd, Gd, Gd, Gs, Gs, Gs, Gs, Gs, Gd, Gd, Dd^Qhu, Gd
Dd, Dd, Dd, Dd, Dd, Dd^Es, Dd, Dd^Dc, Dd^_ml, Dd, Dd^Ftd, Dd, Dd, Dd, Dd^Ftd, Dd, Dd^Qhu, Dd^Qhu, Dd^Qhu, Hhd, Dd^Qhu, Dd^Qhu, Hd^Qhu, Hhd, Hd^Qhu, Hhd, Hhd, Hhd, Md, Hhd, Gd, Gs^Fms, Gd, Gs^Fms, Gd, Gd^Vc, Gd, Dd^Qhu, Hd^Qhu, Hd^Qhu
Dd, Dd^Es, Dd, Dd^Ftd, Dd^Ftd, Dd, Dd, Dd, Dd, Dd^Ftd, Dd, Dd, Dd^Ftd, Dd^Ftd, Dd^Qhu, Dd^Qhu, Dd^Qhu, Dd^Qhu, Dd^Qhu, Dd^Qhu, Hd^Qhu, Hd^Qhu, Hd^Qhu, Hd^Qhu, Hd^Qhu, Md, Md, Md, Md, Hhd, Hhd, Gd, Dd^Qhu, Dd^Qhu, Dd^Qhu, Dd^Qhu, Dd^Qhu, Dd^Qhu, Hd^Qhu, Mdd
Dd, Dd, Dd, Dd, Dd^Ftd, Dd, Dd, Dd, Dd, Dd, Dd, Dd, Dd^Ftd, Dd^Qhu, Dd^Qhu, Dd^Qhu, Dd^Qhu, Dd^Qhu, Hd^Qhu, Hd^Qhu, Mdd, Mdd, Mdd, Mdd, Mdd, Hd^Qhu, Mdd, Md, Hd^Qhu, Hd^Qhu, Hd^Qhu, Dd^Qhu, Dd^Qhu, Dd^Qhu, Hd^Qhu, Dd^Qhu, Dd^Qhu, Hd^Qhu, Mdd, Mdd
