border_size=1
usage=map

Hh, Hh, Hh^Fdf, Hh, Hh^Fdf, Hh^Fdf, Hh, Hh, Gs, Gs^Fds, Gs^Fds, Gs^Fds, Gs^Fds, Dd, Wwt, Dd, Dd^Es, Dd^Es, Wwt, Wwt, Wot, Wot, Wot, Wot, Wot, Wot, Wot, Wot, Wot, Wot, Wot, Wot, Wot, Wot, Wot, Wot, Wot, Wot, Wot, Wot, Wot, Wot, Wot, Wo
Mm, Hh^Fdf, Hh^Fdf, Mm, Hh^Fdf, Hh^Fdf, Hh^Fds, Gs, Gs^Fds, Gs, Gs, Gs, Gs, Gs, Gs, Wwt, Wwt, Wwt, Wot, Wot, Wot, Wot, Wot, Wot, Wot, Wot, Wwt, Wot, Wwt, Wot, Wot, Wot, Wot^Vm, Wot, Wot, Wot, Wot, Wot, Wot, Wot, Wot, Wot, Wo, Wo
Mm, Hh^Fdf, Hh^Fmf, Hh^Fdf, Hh, Hh, Gs, Gs, Hh^Fds, Hh, Hh, Gs^Fds, Gs, Gs^Fds, Gs, Dd, Wwt, Wot, Wot, Wot, Wot, Wot, Wot, Wot, Wot, Wwt, Wwrt, Wwt, Wwrt, Wwt, Wwt, Wot, Wot, Wot, Wot, Wot, Wot, Wot, Wot, Wot, Wo, Wo, Ww, Ww
Hh, Hh^Fmf, Hh^Vo, Hh, Gs, Gs, Gs, Hh, Hh, Mm, Hh, Gs, Gs, Gs, Wwt, Wwt, Wot, Wot, Wot, Wot, Wot^Vm, Wot, Wot, Wot, Wwt, Wwt, Wwt, Wwt, Wwt, Wwrt, Wwt, Wot, Wot, Wot, Wot, Wot, Wo, Wot, Wo, Wo, Ww, Ww, Ww, Ww
Hh, Hh, Hh, Gs, Co, Co, Co, Gs, Hh, Mm, Hh, Gs, Gs, Wwt, Wwt, Wot, Wot, Wot, Wot, Wot, Wot, Wot, Wot, Wot, Wwt, Wwt^Vm, Wwt, Wwt^Vm, Wwt, Wwt, Wot, Wot, Wot, Wot, Wo, Wo, Wo, Wo, Ww, Ww, Ww, Ww, Gs^Ft, Dd^Ftd
Hh^Fdf, Hh^Fms, Gs, Gs, Co, 2 Ko, Co, Gs, Gs, Hh, Gs, Gs, Ww, Ww, Wwt, Wot, Wot, Wot, Wwt, Wwt, Wwt^Vm, Wwt, Wwt, Wwt, Wwt^Fet, Wwt, Chw, Wwt, Wwrt, Wot, Wot, Wot, Wo, Wo, Ww, Ww, Ww, Ww, Ww, Ww, Dd^Ftd, Gs^Ft, Dd^Es, Dd
Hh, Hh, Gs^Fms, Gs, Gs, Co, Gs, Gs, Gs, Gs, Gs, Ww, Ww, Wwt, Wot, Wot, Wot, Wwt, Dd^Ftd, Wwt, Wwt, Wwt, Wwt^Fet, Wwt^Fet, Chw, Wwrt, Wwt^Fet, Chw, Wot, Wot, Wot, Wo, Wo, Ww, Ww, Ww, Ww, Ww, Ww, Ww, Ss, Dd^Es, 3 Dd^Es, Dd^Es
Hh, Gs^Fms, Gs, Gs, Gs^Fds, Gs, Hh, Hh, Gs, Gs, Ww, Ww, Wwt, Wwt, Wot, Wot, Wot, Wwt, Wwt, Wwt, Wwt, Dd^Ftd, Wwt, Chw, Wwt^Fet, Wwt^Fet, Wot, Wot, Wot, Wot, Wo, Wo, Ww, Ww, Ww, Ww, Dd^Ftd, Dd^Ftd, Dd^Es, Ds^Fet, Gs^Ft, Ss, Dd^Es, Gs^Ft
Gs, Gs^Fms, Gs, Gs, Gs^Fds, Hh^Fds, Gs, Gs, Gs, Wwf, Ww, Ww, Wwt, Wot, Wot, Wot, Wwt, Wwt, Wwrt, Wwrt, Wwt, Dd^Ftd, Wwt, Chw, Wot, Wot, Wot^Vm, Wot, Wo, Wo, Wo, Ww, Ww, Ww, Ss, Dd^Ftd, Gs^Ft, Dd^Es, Dd^Vdt, Dd^Es, Ss, Ss, Ss, Ss
Gs^Fms, Hh, Hh, Hh, Hh^Fms, Gs^Fds, Gs, Gs, Wwf, Wwf, Ww, Wwt, Wot, Wot, Wot, Wot, Wwt, Wwt, Wwrt, Wwt, Wwt, Wwt, Wot, Wot, Wot, Wot, Wot, Wot, Wo, Wo, Wwr, Ww, Ww, Ss, Ss, Gs^Ft, Ww^Fet, Dd^Es, Dd^Es, Dd, Ss, Ss, Ss, Dd^Es
Gs, Gs, Hh, Mm, Hh^Fms, Gs^Fms, Gs, Wwf, Ww, Ww, Wwt^Bw\r, Wwt, Wot, Wot, Wwt, Wwt, Dd^Es, Wwrt, Wwrt, Wwrt, Wwt, Wot, Wot, Wot, Wot, Wo, Wo, Wo, Ww, Wwr, Ww, Ww, Ss, Ss, Chw, Ww, Khw, Ww^Fet, Ss, Ss, Dd^Es, Dd^Es, Ss, Dd^Es
Gs, Hh, Hh^Fds, Mm, Hh, Gs, Gs, Dd, Ww, Ww, Wot, Wot^Bw\r, Wot^Bw\r, Wot, Wwt, Dd^Es, Dd^Vhs, Wwrt, Wwrt, Wwt, Wot, Wot, Wot, Wot, Wo, Wo, Wo, Ww, Ww, Ww, Gs^Ft, Ww, Ww, Gs^Ft, Ww^Fet, Chw, Chw, Chw, Ww^Fet, Ss, Dd^Es, Dd^Es, Ss, Ss
Hh, Hh, Gs^Fds, Hh^Fds, Gs, Gs, Ww, Ww, Ww, Wo, Wot, Wot, Wot, Wot^Bw\r, Wwrt, Dd^Es, Wwrt, Dd^Es, Wwrt, Wwt, Wot, Wot, Wot, Wo, Wo, Wwr, Ww, Ww, Ss, Ss, Ss, Gs^Ft, Ss, Ww, Ww^Ewl, Ww, Ss, Ss^Bw|, Ss, Ss, Ss, Ss, Dd^Ftd, Ss
Mm, Hh^Fms, Gs^Fms, Gs^Fms, Gs, Gs, Ww, Ww, Wo, Wo, Wot, Wot, Wot, Wwt, Wwt, Ds^Es, Wwrt, Wwrt, Wwrt, Wot, Wot, Wot, Wo, Wo, Wwr, Ww, Ww, Ww, Ss, Ss^Vhs, Dd^Ftd, Dd^Ftd, Ss, Ss, Ss, Ww^Ewl, Ss, Dd, Dd, Dd^Es, Dd^Ftd, Ss, Dd^Ftd, Ss
Hh, Hh, Gs, Gs, Gs, Ww, Ww, Ww, Wo, Wo, Wot, Wot, Wot, Wwt, Wwt, Wwrt, Wwt, Wwrt, Wot, Wot^Bw\r, Wot^Bw\r, Wot, Wo, Wo, Ww, Ww, Wwf, Ss, Dd^Ftd, Ss, Ss, Dd, Dd^Es, Dd^Ftd, Ss, Ss, Dd^Ftd, Ss, Dd^Es, Dd^Vdt, Dd^Es, Ss, Dd^Ftd, Ww
Gs, Gs, Gs^Vht, Gs, Ww, Ww, Ww, Wo, Wo, Wo, Wot, Wot, Wot, Wot, Wot, Wwt, Wwt, Wwrt, Wot, Wot, Wot, Wot^Bw\r, Wo^Bw\r, Ww, Ww, Wwf, Ss, Ss, Ss, Dd, Dd, Dd^Es, Dd^Es, Ss, Dd^Ftd, Dd, Dd^Es, Dd, Ss, Dd^Es, Ss, Dd^Es, Ww, Ww
Gs^Fms, Gs, Gs, Gs, Ww, Ww, Ww, Wo, Wo, Wot, Wot, Wot, Wot, Wot, Wot, Wwt, Wwt, Wot, Wot, Wot, Wo, Wwr, Wwr, Wwr, Wwf^Bw\r, Wwf, Ss, Ss, Dd^Es, Dd, Ss, Ss, Ss, Ss, Dd, Hd, Dd^Es, Dd, Dd, Ss, Ss, Ww, Ss, Gs^Ft
Gs^Fms, Gs, Gs, Ww, Ww, Ww, Wo, Wo, Wo, Wot, Wot, Wot, Wot, Wot, Wot, Wot^Vm, Wot, Wot, Wot, Wot, Wo, Wo, Wwr, Wwr, Wwf, Dd, Dd^Ftd, Ss, Dd, Dd^Es, Ss, Ss, Ss, Dd^Es, Dd^Es, Dd, Hh^Ft, Dd, Dd, Dd^Ftd, Ww, Ww, Ss, Gs^Ft
Gs^Fms, Gs, Ww, Ww, Ww, Ww, Wo, Wo, Wo, Wot, Wot, Wot, Wot, Wot, Wot, Wot, Wot, Wot, Wot, Wo, Wo, Wwr, Wwr, Wwf, Wwf, Dd, Ss, Dd^Es, Ss, Dd^Es, Ss, Ss, Ss, Dd^Ftd, Ss, Gs^Ft, Gs^Ft, Dd^Ftd, Dd, Ww^Bw\, Dd, Ss, Dd^Ftd, Ss
Gs^Fms, Gs, Ww, Ww, Ww, Ww, Wo, Wo, Wot, Wot, Wot, Wot, Wot, Wot, Wot, Wot, Wot, Wot, Wo, Wo, Wo, Wwr, Wwr, Wwf, Dd, Dd^Ftd, Gs^Ft, Ss, Ss^Vhs, Ss, Gs^Ft, Gs^Ft, Gs^Ft, Ss, Ss, Ss, Ss, Ss, Ww, Ww, Dd^Es, Dd^Es, Dd^Vda, Dd^Ftd
Gs, Gs, Ww, Ww, Ww, Wo, Wo, Wo, Wot, Wot, Wot, Wot, Wot, Wot, Wot, Wot, Wot, Wot, Wo, Wo, Ww, Ww, Wwf, Wwf, Dd^Ftd, Gs^Ft, Gs^Ft, Ss, Gs^Ft, Ss, Ss, Hh^Ft, Gs^Ft, Ss, Ww, Ww, Ww, Ww, Ss, Ss, Ss, Dd^Es, Dd, Dd
Gs, Ww, Ww, Ww, Ww, Wo, Wo, Wo, Wot, Wot, Wot, Wot, Wot, Wot, Wot, Wot, Wot, Wot, Wo, Wo, Ww, Ww, Wwf, Dd, Gs^Ft, Gs^Ft, Dd^Es, Gs^Ft, Dd^Es, Gs^Ft, Gs^Ft, Hh^Ft, Gs^Ft, Ww, Ss, Ss, Gs^Ft, Gs^Ft, Dd^Es, Ss, Dd^Es, Ss, Ss, Dd^Es
Gs, Ww, Ww, Ww, Wo, Wo, Wo, Wo, Wot, Wot, Wot, Wot, Wot, Wot, Wot, Wot, Wot, Wo, Wo, Wo, Ww, Wwf, Ds, Dd, Dd^Es, Dd^Es, Rd, Dd, Rd, Dd^Es, Dd^Es, Gs^Ft, Ww, Ww, Ss, Dd^Es, Dd^Es, Dd^Ftd, Dd^Es, Dd^Es, Ss, Ss, Gs^Ft, Dd
Ww, Ww, Ww, Ww, Wo, Wo, Wo, Wot, Wot, Wot, Wot, Wot, Wot, Wot, Wot, Wot, Wo, Wo, Wo, Wwr, Ww, Wwf, Rd, Rd, Rd, Rd, Dd, Rd, Dd^Es, Rd, Ww^Bw\, Ww, Dd, Dd^Es, Dd^Es, Ss, Ss, Gs^Ft, Gs^Ft, Gs^Ft, Ss, Ss, Gs^Ft, Gs^Ft
Ww, Ww, Ww, Ww, Wo, Wo, Wo, Wot, Wot, Wot, Wot, Wot, Wot, Wot, Wot, Wot, Wo, Wo, Wo, Wwr, Ww, Ww, Sm, Dd, Dd, Dd, Ss, Dd^Es, Ss, Ww, Dd^Es, Rd^Es, Rd, Rd, Rd, Gs^Ft, Ss, Ss, Ss, Ss, Dd, Ss, Ss, Ss
Ww, Ww, Ww, Wo, Wo, Wo, Wot, Wot, Wot, Wot, Wot, Wot, Wot, Wot, Wo, Wo, Wo, Wo, Ww, Ww, Ww, Ss, Ss, Dd, Dd^Es, Dd^Es, Gs^Ft, Ss, Ww, Ww, Ss, Dd^Es, Ss, Gs^Ft, Ss, Ss^Bw\, Rd, Gs^Ft, Dd, Dd, Dd, Dd, Dd, Dd
Ww, Ww, Wo, Wo, Wo, Wo, Wot, Wot, Wot, Wot, Wot, Wot, Wo, Wo, Wo, Wo, Ww, Ww, Ww, Ww, Dd^Ftd, Ss, Ss, Dd, Dd^Ftd, Ss, Ss, Ss, Ww, Ss, Ss, Ss, Dd^Ftd, Ss, Dd^Es, Gs^Ft, Gs^Ft, Rd, Rd, Dd^Es, Dd^Es, Dd^Es, Dd, Dd^Ftd
Ww, Ww, Wo, Wo, Wo, Wo, Wot, Wot, Wot, Wot, Wot, Wot, Wo, Wo, Wo, Ww, Ww, Ww, Ww, Ww, Dd^Ftd, Dd^Es, Ss, Gs^Ft, Gs^Ft, Ss, Ww, Ww, Ss, Ss, Ss, Ss, Gs^Ft, Dd, Dd^Vda, Dd^Es, Dd, Dd, Dd^Es, Rd, Rd, Rd, Rd, Dd^Ftd
Ww, Wo, Wo, Wo, Wo, Wot, Wot, Wot, Wot, Wot, Wot, Wo, Wo, Wo, Wo, Ww, Ww, Ww, Dd^Ftd, Dd^Ftd, Dd^Es, Ss, Ss^Vhs, Ss, Ss, Ss, Ww, Ww, Gs^Ft, Gs^Ft, Dd^Ftd, Ss, Ss, Dd^Ftd, Dd, Dd, Hd^Ftd, Hd^Ftd, Hd^Ftd, Dd^Es, Dd, Dd, Dd^Ftd, Rd
Wo, Wo, Wo, Wo, Wo, Wot, Wot, Wot, Wot, Wot, Wo, Wo, Wo, Wo, Ww, Ww, Ww, Ww, Ww, Dd^Ftd, Ww, Ss, Ww, Ww, Ww, Ww, Gs^Ft, Dd^Ftd, Dd, 1 Dd^Ftd, Dd^Ftd, Dd^Ftd, Dd^Ftd, Gs^Ft, Gs^Ft, Gs^Ft, Hd^Ftd, Md, Md, Hd^Ftd, Hd^Ftd, Hd^Fts, Dd^Ftd, Rd
Wo, Wo, Wo, Wo, Wot, Wot, Wot, Wot, Wot, Wot, Wo, Wo, Wo, Wo, Ww, Ww, Ww, Ww, Dd^Ftd, Ww, Ss, Ww, Gs, Gs^Ftp, Gs^Ftp, Gs^Ftp, Gs^Ft, Dd^Ftd, Dd^Ftd, Dd^Ftd, Dd^Ftd, Dd^Ftd, Dd^Ftd, Gs^Ft, Hd^Ftp, Hd, Md, Md, Md, Hd^Ftd, Hd^Ftp, Hd^Fts, Dd^Ftd, Rd
Wo, Wo, Wo, Wot, Wot, Wot, Wot, Wot, Wot, Wo, Wo, Wo, Wo, Wo, Ww, Ww, Ww, Dd^Ftd, Dd^Ftd, Dd^Ftd, Ss, Gs, Gs^Es, Gs^Ftp, Gs^Ftp, Gs, Gs^Ftp, Dd^Ftd, Gs^Ftp, Dd^Ftd, Dd^Ftd, Dd^Ftd, Dd^Ftd, Gs^Ft, Hd^Es, Md, Hd^Ftd, Md, Md, Mm, Hd^Ftp, Hd^Ftp, Hd^Ftp, Hd^Ftp
Wo, Wo, Wot, Wot, Wot, Wot, Wot, Wot, Wo, Wo, Wo, Wo, Wo, Wo, Ww, Ww, Dd^Ftd, Dd^Ftd, Dd^Ftd, Ss, Gs, Gs^Es, Gs^Ftp, Gs^Ftp, Hh^Es, Gs, Gs, Gs^Ftp, Dd, Dd^Ftd, Dd^Ftd, Dd^Ftd, Hd^Ftp, Hd^Es, Md, Md, Hd^Ftd, Md, Md, Mm, Hd^Ftd, Hd^Fts, Dd^Ftp, Hd^Ftp
Wo, Wo, Wot, Wot, Wot, Wot, Wot, Wot, Wo, Wo, Wo, Wo, Wo, Ww, Ww, Ww, Dd^Ftd, Dd^Ftd, Ss, Ss, Gs, Gs, Gs^Ftp, Gs^Ftp, Gs, Gs^Es, Gs^Ft, Dd^Ftd, Dd^Ftd, Dd^Ftd, Dd^Ftd, Hd, Hd^Ftp, Md, Md, Hd, Hd^Ftd, Md, Md, Hd^Ftd, Hd^Ftd, Hd^Fts, Dd^Ftd, Hd
