Xu, Xu, Xu, Xu, Xu, Xu, Xu, Xu, Uu, Uu, Uu, Ur, Uu, Uu, Uu, Xu, Xu, Xu, Xu, Xu, Uu, Xu, Xu, Xu, Xu, Xu, Xu, Xu, Xu, Xu, Xu, Xu, Xu, Xu, Xu, Xu, Xu, Xu
Xu, Xu, Xu, Xu, Uu, Uu, Uu, Uu, Uu, Uu, Uu, Ur, Uu, Uu, Uu, Xu, Xu, Xu, Uu^Mcy, Uu, Uu^Vud, Uu, Uu, Uu, Uu, Uu, Uu, Xu, Xu, Xu, Uu, Uu, Uu, Xu, Uh, Xu, Xu, Xu
Xu, Xu, Uu, Uu, Qxu, Qxu, Qxu, Uu, Uu, Uu^Vud, Uu, Ur, Uu, Uu, Uu, Xu, Xu, Uu^Xo, Uu^Mcy, Uu, Uu, Uu, Ur, Uu, Uu, Qxu, Uu, Xu, Xu, Uu^Vud, Uu, Cud, Uu, Uu, Uu, Xu, Xu, Xu
Xu, Xu, Uu, Uu, Uu, Qxu, Uu, Uu, Uu, Uu, Ur, Ur, Uu, Uu, Uu, Xu, Xu, Xuc, Uu, Uu, Ur, Ur, Uu, Ur, Ur, Uu, Uu, Xu, Xu, Xu, Xu, Uu, Uu, Cud, Uu, Uu, Xu, Xu
Xu, Xu, Uu, Uu, Uu, Uu, Uu, Uu, Cud, Ur, Uu, Uu, Uu, Qxu, Qxu, Uu, Uu, Xu, Xu, Uu, Uu, Uu, Xu, Uu, Uu, Ur, Ur, Uu, Uu, Xu, Xu, Uu, Uu, Uu, Uu, Uu^Tf, Xu, Xu
Xu, Uu, Uu, Uu, Uu^Vud, Uu, Uu, Cud, Kud, Cud, Uu, Uu, Uu^Tf, Uu, Uu, Qxu, Uu, Uu, Uu, Xu, Xu, Xu, Uu, Xu, Xu, Uu, Uu, Ur, Ur, Uu, Uu, Xu, Xu, Uu, Uu^Tf, Xu, Xu, Xu
Xu, Uu, Uu, Uu, Uu, Uu, Uu, Cud, Cud, Cud, Uu, Uu, Uu, Uu, Uu^Vud, Uu, Uu, Uu, Uu, Xu, Uu, Uu, Ur, Uu, Uu, Xu, Xu, Uu, Uu, Ur, Ur, Uu, Uu, Xu, Xu, Xu, Xu, Xu
Xu, Uu, Qxu, Uu, Uu, Uu, Uu, Uu, Uu, Ur, Ur, Uu, Uu, Uu, Uu, Uu, Uu, Uu, Uu, Uu, Ur, Ur, Uu, Ur, Ur^Xo, Xu, Uu, Xu, Xu, Uu, Uu, Ur, Ur, Uu, Uu, Xu, Xu, Xu
Xu, Uu, Qxu, Qxu, Uu, Uu, Uu^Tf, Uu, Uu, Uu, Uu, Ur, Uu, Ur, Uu, Ur, Uu, Ur, Ur, Ur, Uu, Uu, Xu, Xu, Uu, Ur, Ur, Uu, Uu^Tf, Xu, Uu, Uu, Ur, Uu^Vud, Uu, Xu, Xu, Xu
Xu, Uu, Uu, Uu, Uu, Uu, Uu, Uu, Uu^Vud, Uu, Uu, Uu, Qxu, Uu, Uu, Uu, Uu, Uu, Uu, Uu, Xu, Xu, Uu, Uu, Uu, Uu, Ur, Uu, Uu, Xu, Uu, Cud, Uu, Ur, Uu, Uu, Uu, Xu
Xu, Xu, Xu, Xu, Xu, Uu, Uu, Uu, Uu, Uu, Uu, Qxu, Qxu, Uu, Uu, Uu^Vud, Uu, Uu, Xu, Xu, Uu, Uu, Uu, Uu, Uu, Uu, Ur, Uu, Uu, Xu, Xu, Uu, Uu, Ur, Uu, Qxu, Uu, Xu
Uh, Xu, Xu, Xu, Xu, Xu, Xu, Uu, Uu, Uu, Uu, Uu, Uu, Uu, Uu, Uu, Xu, Xu, Uu, Uu, Uu, Uu, Uu, Uu, Uu, Uu, Ur, Uu, Uu, Uu, Uu^Tf, Xu, Uu, Ur, Ur, Uu, Xu, Xu
Uu, Uu^Vu, Uu, Uh, Uh, Xu, Xu, Xu, Xu, Uu, Uh, Xu, Uh, Uu, Xu, Xu, Uu, Uu, Uu, Uu, Uu, Uu, Uu, Uu, Ur, Ur, Uu, Uu, Uu, Uu, Uu, Xu, Xu, Uu, Ur, Uu, Xu, Xu
Xu, Xu, Uu, Uu, Uu, Uh, Uh, Xu, Xu, Xu, Xu, Xu, Xu, Xu, Uu^Tf, Uu, Uu, Uu, Uu, Uu, Uu, Uu, Uu, Uu, Ur, Uu, Uu, Uu, Uu, Uu, Uu, Xu, Xu, Uu, Ur, Uu, Xu, Xu
Xu, Uu^Tf, Uu, Uu, Uu, Uu, Uh, Xu, Xu, Xu, Uu, Uh, Uu, Xu, Xu, Uu, Uu, Uu, Uu, Uu, Uu, Uu, Uu, Uu, Ur, Uu, Uu, Uu, Uu, Uu, Uu, Xu, Xu, Uu, Ur, Uu, Xu, Xu
Uh, Uh, Uh, Uu, Uu, Uu, Uu, Xu, Xu, Uu, Ur, Ur, Ur, Uu, Uu, Xu, Xu, Uu, Uu, Uu, Uu, Uu, Ur, Ur, Uu, Uu, Uu, Uu, Uu, Uu, Uu, Xu, Uu, Uu, Ur, Uu, Xu, Xu
Qlf, Qlf, Qlf, Uh, Uu, Uu, Uu, Uu, Xu, Uu, Ur, Uu^Vud, Uu, Ur, Ur, Uu, Xu, Xu, Xu, Uu, Ur, Ur, Uu, Uu, Uu, Uu, Uu, Uu, Uu, Uu, Uu^Tf, Xu, Uu, Ur, Uu, Uu, Xu, Xu
Qlf, Qlf, Qlf, Uh, Ur, Ur, Ur, Uu, Xu, Uu, Ur, Uu, Xu, Uu, Ur, Uu, Xu, Uu, Ur, Ur^Xo, Xu, Uu, Uu, Uu, Uu, Uu, Uu, Uu, Uu, Uu, Xu, Xu, Uu, Ur, Uu, Xu, Xu, Xu
Qlf, Qlf, Cud, Qlf^Bs/, Uh, Uu, Ur, Uu, Xu, Uu, Ur, Uu, Xu, Uu, Ur, Uu, Uu, Uu, Ur, Uu, Uh, Xu, Uu, Uu, Uu, Uu, Uu, Uu, Xu, Xu, Uu, Uu, Ur, Ur, Uu, Xu, Xu, Xu
Qlf, Qlf, Qlf, Qlf, Uh, Uu, Ur, Uu, Xu, Uu, Ur, Uu, Xu, Uu, Uu, Ur, Ur, Qxu, Ur, Uu, Uu, Xu, Xu, Uu, Uu, Uu, Xu, Xu, Uu, Uu, Ur, Ur, Uu^Tf, Ur^Vud, Uu, Uu, Xu, Xu
Qlf, Qlf, Qlf, Qlf, Uh, Uu, Ur, Uu, Xu, Uu, Ur, Uu, Uu, Xu, Xu, Uu, Uu, Ur, Ur, Ur, Ur, Uu, Uu, Xu, Xu, Xu, Uu, Uu, Ur, Ur, Uu, Uu, Uu, Ur, Uu, Xu, Xu, Sm
Qlf, Qlf, Qlf, Uh, Uh, Uu, Ur, Uu, Xu, Uu, Uu, Ur, Ur, Uu, Uu, Xu, Xu, Uu, Ur, Uu^Tf, Uu, Ur, Ur, Uu, Uu, Uu, Ur, Ur, Uu, Uu, Xu, Xu, Uu, Ur, Uu, Xu, Sm, Sm
Qlf, Qlf, Qlf, Qlf, Uh, Uu, Ur, Uu, Xu, Xu, Xu, Uu, Uu, Ur, Ur, Uu, Xu, Uu, Ur, Uu, Xu, Uu, Uu, Ur, Ur, Ur, Uu, Uu, Xu, Xu, Uu, Uu, Ur, Ur, Uu, Sm, Wwg, Wwg
Qlf, Qlf, Qlf, Qlf, Uh, Uu, Ur, Uu, Xu, Uu^Xo, Uu^Mcy, Xu, Xu, Uu, Ur, Uu, Xu, Uu, Ur, Uu, Xu, Cud, Uu^Vud, Uu, Uu, Uu, Xu, Xu, Uu, Uu, Ur, Ur, Uu, Uu, Sm, Sm, Wwg, Wwg
Qlf, Qlf, Qlf, Uh, Uu, Uu, Ur, Uu, Xu, Uu^Mcy, Uu, Uu, Xu, Uu, Ur, Uu, Xu, Uu, Ur, Uu, Xu, Kud, Cud, Cud, Xu, Xu, Uu, Xu, Uu, Ur, Uu, Uu, Sm, Sm, Sm, Wwg, Wog, Wog
Uh, Qlf, Qlf, Uh, Uu, Uu, Uu, Uu, Xu, Uu, Uu, Uu, Xu, Uu, Ur, Uu, Xu, Uu, Ur, Uu, Xu, Xu, Xu, Xu, Uu, Uu, Uu, Xu, Uu, Uu, Sm, Sm, Wwg, Sm, Wwg, Wwg, Wog, Wog
Uh, Qlf, Uh, Uh, Uu, Xu, Xu, Uu, Xu, Uu, Ur, Uu, Xu, Uu, Ur, Uu, Xu, Uu, Ur, Uu, Uu, Xu, Xu, Uu, Uu, Cud, Uu, Xu, Uu, Sm, Sm, Sm, Wwg, Wwg, Wog, Wog, Wog, Wog
Uu, Uh, Uu, Uu, Uu^Vud, Uu, Uu, Xu, Xu, Uu, Ur, Uu, Uu, Uu, Ur, Uu, Xu, Uu, Uu, Ur, Ur, Uu, Uh, Xu, Xu, Uu, Xu, Xu, Uu, Uu^Vud, Sm, Wwg, Wog, Wwg, Wog, Wog, Wog, Wwg
Xu, Uu, Uu, Uu, Uu, Uu, Xu, Xu, Uu, Uu, Uu, Ur, Ur, Uu^Vud, Ur, Uu, Uu, Xu, Xu, Uu, Uu, Uu, Uu, Xu, Uu^Tf, Xu, Uu, Uu, Sm, Sm, Wwg, Wwg, Wog, Wog, Wwg, Wog, Wwg, Wwg
Xu, Xu, Xu, Xu, Xu, Xu, Xu, Uu, Cud, Uu, Uu, Uu, Uu, Ur, Uu, Uu, Qxu, Uu, Uu, Xu, Uu, Ur, Uu, Xu, Uu, Uu, Uu, Sm, Wwg, Wwg, Wog, Wog, Wwg, Wwg, Sm, Wwg, Sm, Sm
Xu, Xu, Xu, Xu, Xu, Xu, Xu, Uu, Uu, Uu, Xu, Uu, Xu, Uu, Xu, Uu, Uu, Qxu, Uu, Xu, Uu, Ur, Uu, Xu, Uu, Uu, Sm, Sm, Wwg, Wog, Wwg, Wwg, Sm, Sm, Uu, Sm, Sm, Uu
Ms, Ms, Ms, Ms, Ms, Xu, Xu, Xu, Xu, Xu, Xu, Xu, Xu, Xu, Xu, Xu, Xu, Uu, Xu, Xu, Uu, Ur, Uu, Xu, Uu, Uu, Sm, Wwg, Wog, Wog, Wwg, Sm, Uu, Uu, Uh, Uu, Uu, Uu
Ha, Ha^Fmf, Ha^Fmf, Ha^Fmf, Ha^Fmf, Ms, Ms, Xu, Xu, Xu, Ms, Ms, Ms, Ms, Ms, Ms, Ms, Xu, Uu, Uu, Ur, Ur, Uu, Xu, Uu, Uu, Sm, Wwg, Wog, Wwg, Sm, Sm, Uu, Uh, Uu^Vud, Uu, Uu, Uu
Ha^Fmf, Ha^Fmf, Ha^Fmf, Ha^Fmf, Ha^Fmf, Ha^Fmf, Ha^Fmf, Ms, Ms, Ms, Ha^Fmf, Ha^Fmf, Ha^Fmf, Ha^Fmf, Ha^Fmf, Ha, Hh, Hh, Hh, Ur, Uu, Uu, Xu, Xu, Uu, Uu, Sm, Wwg, Wog, Wwg, Wwg, Sm, Sm, Uu, Uu, Uu, Uu^Tf, Uu
Aa^Fmf, Aa^Fmf, Aa^Fmf, Aa^Fmf, Hh^Fmf, Aa, Aa, Ha, Ha, Ha, Aa, Aa^Fmf, Aa, Aa^Fmf, Aa, Hh, Gs, Gs, Gs, Hh, Ha, Xu, Xu, Xu, Uu, Uu, Sm, Wwg, Wwg, Wog, Wog, Wwg, Wwg, Sm, Sm, Uu, Sm, Uu
Aa, Aa, Aa, Hh^Fmf, Hh, Hh, Aa, Aa, Aa, Aa, Gs, Aa, Gs, Gs, Gs, Gs, Hh^Fmf, Hh, Ha, Ha, Ms, Ms, Xu, Xu, Uu, Uu, Uu, Sm, Sm, Wwg, Wwg, Wog, Wog, Wwg, Wwg, Sm, Sm, Uu
Aa, Aa^Fmf, Aa, Aa, Aa, Gs, Gs, Gs, Gs, Gs, Gs, Gs, 1 Gs, Gs, Aa, Hh, Hh^Fmf, Ha^Fmf, Ha^Fmf, Ms, Ms, Ms, Xu, Xu, Uu, Uu^Vud, Uu, Uu, Uu, Sm, Sm, Wwg, Wwg, Wwg, Wwg, Sm, Sm, Sm
Aa, Aa, Aa, Gs, Gs, Gs, Aa, Aa, Gs, Gs, Gs, Gs, Gs, Gs, Ha, Aa^Fmf, Ha^Fmf, Ha^Fmf, Ha, Ms, Ms, Ms, Xu, Xu, Xu, Uu, Xu, Uu, Uu, Uu, Uu, Sm, Sm, Sm, Sm, Sm, Uu, Sm
Gs, Gs, Gs, Gs, Gs, Gs, Gs, Gs, Aa, Aa, Hh, Gs, Aa, Hh, Aa^Fmf, Aa^Fmf, Ha^Fmf, Ha, Ha^Fmf, Ha, Ms, Ms, Ms, Xu, Xu, Xu, Xu, Xu, Xu, Uu, Uu, Uu, Uu, Sm, Uu, Sm, Uu, Uu
Aa, Gs, Gs, Gs, Aa, Aa, Aa, Aa, Ha, Aa, Aa, Hh, Aa, Ha^Fmf, Aa, Aa^Fmf, Ha, Ha^Fmf, Ha, Ms, Ms, Ms, Ms, Xu, Xu, Xu, Xu, Xu, Xu, Xu, Xu, Uu, Uu, Uu, Uu, Uu, Uu, Uu
