Hh, Hh^Fmf, Hh^Fmf, Mm, Mm, Hh, Hh, Hh, Mm, Hh, Md, Md, Md, Hh, Hh, Gs, Gs, Gs, Hh, Hh, Mm, Mm, Mm, Hh, Mm, Mm, Mm, Mm, Hh, Hh, Gs^Fmf, Gs, Gs^Es, Gs, Gs, Gs, Ds^Es, Ds^Es, Ds, Ds, Ww, Ww, Wwt, Wot, Wot, Wot, Wot, Wot, Wot, Wot
Gs, Hh^Fmf, Mm, Hh^Fmf, Hh, Hh, Hhd^Qhu, Hhd^Qhu, Mm, Mm, Md, Md, Md, Md, Hh^Vht, Hh, Hh, Gs, Gs, Hh^Fmf, Hh^Fmf, Mm, Hh, Mm, Hh^Fmf, Hh^Fmf, Hh, Hh, Gs^Fmf, Gs^Fmf, Gs, Gs, Gs, Gs^Es, Ds^Es, Ds^Es, Ds, Ds, Ww, Ww, Ww, Ww, Wwt, Wot, Wot, Wot, Wot, Wot, Wot, Wot
Gs, Hh^Fmf, Hh, Hh, Hhd^Qhu, Hhd^Qhu, Hd, Hhd^Qhu, Hhd^Qhu, Hhd^Qhu, Hhd^Qhu, Hhd^Qhu, Hhd^Qhu, Md, Md, Md, Hh, Gs, Gs, Gs^Fmf, Gs^Es, Hh, Gs, Hh^Fmf, Gs, Gs, Gs, Gs, Gs, Gs, Hh, Gs, Gs^Vht, Gs, Ds, Ds^Es, Ds, Ww, Ww, Ww, Wwt, Wwt, Wot, Wot, Wot, Wot, Wot, Wot, Wot, Wot
Hh, Mm, Hh, Hhd^Qhu, Hhd, Hhd, Hd, Hd, Hd, Hd, Hd, Hhd, Hd, Hhd^Qhu, Hh, Md, Md, Hh, Hh, Gs, Gs^Es, Gs^Es, Hh, Gs, Gs, Dd, Dd^Es, Dd, Gs, Hh, Gs, Gs, Gd, Gd, Ds^Es, Ds, Ww, Ww, Wwt, Wwt, Wot, Wot, Wot, Wot, Wot, Wot, Wot, Wot, Wot, Wot
Hh, Hh^Ftp, Hhd^Qhu, Hhd^Qhu, Hhd^Es, Hd, Dd^Es, Dd^Es, Dd^Es, Dd^Es, Hd, Hd, Hhd, Hhd^Qhu, Hh, Hh^Ftp, Hh^Ftp, Md, Hh, Hh, Gs^Ftp, Hh, Hh, Gs, Dd, Dd^Es, 1 Dd, Dd, Gs, Gs, Gs, Gs^Es, Ds, Ds, Ds, Ds, Ww, Ww, Wwt, Wwt, Wot, Wot, Wot, Wot, Wot, Wot, Wot, Wot, Wot, Wot
Hh, Hh^Ftp, Hhd^Qhu, Hhd^Vht, Hd^_ml, Hd, Hd, Hd^Es, Hd, Dd^Es, Hd^Es, Hd, Hhd, Hhd^Qhu, Mm, Hh^Ftp, Hh, Md, Md, Hh, Gs^Ftp, Gs^Ftp, Gs, Gs, Gs, Dd, Dd, Ss, Wwt, Gs, Wwt, Gs, Wwt, Ds, Ww, Ww, Wwt, Wwt, Wot, Wot, Wot, Wot, Wot, Wot, Wot, Wot, Wot, Wot, Wot, Wot
Mm, Hhd^Qhu, Hhd^Qhu, Hhd^Qhu, Hhd^Qhu, Hhd, Hhd^Qhu, Hd^Es, Hhd, Hd, Hhd, Hd, Hd, Hhd^Qhu, Mm, Hh, Hh, Md, Md, Hh, Hh, Hh, Hh, Gs, Gs, Dd, Gs, Dd, Wwt, Wwt, Wwt, Wwt, Wwt, Wwt, Wwt, Wwt, Wwt, Wwt, Wot, Wot, Wot, Wot, Wot, Wot, Wot, Wot, Wot, Wot, Wot, Wot
Mm, Md, Md, Md, Md, Hhd^Qhu, Md, Hhd^Qhu, Hhd^Qhu, Hhd^Qhu, Hhd^Qhu, Hhd^Qhu, Hhd^Qhu, Hhd^Qhu, Hhd^Qhu, Mm, Mm, Hh, Hh^Es, Hh, Gs^Es, Hh, Gs, Gs, Ww, Gs, Ww, Ww, Ww, Ww, Gs, Ww, Ww, Wwt, Ww, Wwt, Wwt, Wwt, Wwt, Wot, Wot, Wot, Wot, Wot, Wot, Wot, Wot, Wot, Wot, Wot
Hh, Hh, Hh, Hh, Hh, Md, Hh, Md, Md, Md, Md, Md, Md, Md, Mm, Mm, Hh, Hh^Fmf, Hh, Hh^Es, Gs, Gs, Gs, Gs, Ww, Ww, Ww, Ww, Gs, Gs, Gs^Es, Ds, Ds, Ds, Ds, Ww, Ww, Wwt, Wwt, Wwt, Wot, Wot, Wot, Wot, Wot, Wot, Wot, Wot, Wot, Wot
Gs, Gs, Gs, Gs, Gs, Hh, Hh, Hh, Hh, Hh, Hh, Hh, Hh, Hh, Hh, Hh, Gs^Es, Hh, Gs, Gs^Es, Gs, Ss, Ww, Ww, Ww, Gs, Gs, Gs, Gs^Es, Gs, Gs^Vht, Ds^Es, Ds, Ds^Es, Ds^Es, Ds, Ds, Ww, Ww, Wwt, Wwt, Wot, Wot, Wot, Wot, Wot, Wot, Wot, Wot, Wot
Ww, Ww, Ww, Ss, Ww, Gs, Gs, Gs, Gs, Gs, Gs, Gs, Gs, Hh^Fmf, Gs^Fmf, Gs, Ww, Gs, Ww, Ww, Ww, Ww, Gs, Ww, Gs^Es, Gs^Es, Hh, Hh, Hh, Gs, Hh, Gs, Gs, Gd, Gd, Ds, Ds, Ww, Ww, Wwt, Wwt, Wwt, Wwt, Wot, Wot, Wot, Wot, Wot, Wot, Wot
Ss, Ww, Ss, Ww, Ww, Ww, Ww, Ww, Ww, Ss, Ww, Ss, Ww, Gs, Ww, Ww, Ww, Ww, Ww, Ww, Ww, Ww, Gs^Es, Gs^Es, Hh, Hh, Mm, Hh, Mm, Hh, Hh, Gs^Ftp, Hh^Ftp, Gs, Gd, Ds^Es, Ds^Es, Ds, Ds, Ww, Ww, Wwt, Wwt, Wwt, Wot, Wot, Wot, Wot, Wot, Wot
Ss, Ss, Ss, Ss, Ss, Ww, Ss, Ww, Ww^Ewl, Ww, Wo, Ww, Wo, Ww, Ww, Ss, Gs^Ftp, Ww, Gs, Gs, Gs, Gs^Ftp, Hh^Ftp, Hh, Mm^Xm, Mm^Xm, Mm^Xm, Mm^Xm, Mm^Xm, Mm^Xm, Mm^Xm, Mm, Mm, Hh, Gs^Ftp, Gd^Es, Gd^Es, Ds^Es, Ds^Es, Ds, Ww, Wwt, Wwt, Wwt, Wwt, Wot, Wot, Wot, Wot, Wot
Gs, Gs, Gs, Gs, Gs, Ss, Gs, Ss, Ss, Ww, Wo, Wo, Ww, Ww, Ss, Gs^Ftp, Gs^Ftp, Gs^Ftp, Gs^Ftp, Gs^Ftp, Hh^Es, Hh^Es, Mm^Xm, Mm^Xm, Xu^Qhh, Xu^Qhh, Xu^Qhh, Xu^Qhh, Xu^Qhh, Xu^Qhh, Xu^Qhh, Mm^Xm, Mm^Xm, Hh^Ftp, Hh^Ftp, Gs^Ftp, Gs, Ds^Es, Ds, Ds, Ds, Ww, Ww, Wwt, Wwt, Wwt, Wot, Wot, Wot, Wot
Gs, Gs^Es, Gs, Hh, Hh, Gs, Ss, Ss, Ss, Ww, Ww, Wo, Ww, Ss, Gs^Ftp, Gs^Ftp, Hh^Ftp, Gs^Ftp, Hh^Ftp, Hh^Ftp, Mm^Xm, Mm^Xm, Xu^Qhh, Xu^Qhh, Uu, Uu, Uu^Tf, Uu, Uu, Uu, Uu, Xu^Qhh, Xu^Qhh, Mm^Xm, Mm^Xm, Hh^Ftp, Hh^Ftp, Gs, Gs, Ds^Es, Ds^Es, Ds, Ds, Ww, Wwt, Wwt, Wot, Wot, Wot, Wot
Gs, Gs^Vht, Gs^Es, Gs, Gs, Gs, Gs, Gs, Gs, Ss, Ww, Ww, Ss, Gs^Ftp, Hh^Ftp, Hh^Ftp, Mm, Hh^Ftp, Mm^Xm, Mm^Xm, Xu^Qhh, Xu^Qhh, Uu, Uu, Uu, Uu, Uu, Uu, Ds, Uu, Dd, Uu, Uu, Xu^Qhh, Xu^Qhh, Mm^Xm, Mm^Xm, Hh, Gs, Gd, Ds, Ds^Es, Ds^Es, Ww, Ww, Wwt, Wwt, Wot, Wot, Wot
Gs, Gs^Es, Gs^Fmf, Gs, Ss, Gs^Ftp, Ss, Gs^Ftp, Ss, Gs, Gs, Ww, Ww, Ss, Ss, Hh^Ftp, Mm, Mm, Mm^Xm, Xu^Qhh, Uu, Uu, Uu, Uu, Dd, Ds, Ds, Ds, Hd, Dd, Dd, Dd, Dd^Vht, Uu, Uu, Xu^Qhh, Mm^Xm, Hh, Gs, Gd, Gd, Ds^Es, Ds^Es, Ds, Ds, Ww, Wwt, Wot, Wot, Wot
Gs, Gs, Gs^Es, Gs, Gs, Ss, Gs, Ss, Gs, Gs, Hh, Gs^Ftp, Gs^Ftp, Ww, Ss, Hh^Ftp, Hh^Ftp, Mm, Mm^Xm, Xu^Qhh, Uu, Uu, Dd, Dd, Dd, Dd^Es, Dd, Hd, Dd, Dd, Csz, Dd, Dd, Dd, Uu, Xu^Qhh, Mm^Xm, Hh, Hh, Gs, Gs^Vht, Gd, Ds^Es, Ds, Ds, Ww, Ww, Wwt, Wot, Wot
Gs^Fmf, Gs^Fmf, Gs^Fmf, Gs^Fmf, Gs^Fmf, Gs, Gs, Gs, Hh, Hh, Hhd^Qhu, Hh, Gs, Ww, Ww, Ss, Ss, Hh^Ftp, Mm^Xm, Xu^Qhh, Uu, Dd, Dd^Es, Dd, Hd, Dd, Dd^Vht, Dd, Dd, Csz, 2 Csz^Ksy, Csz, Dd, Dd, Uu, Xu^Qhh, Mm^Xm, Mm, Hh^Ftp, Gs, Gs, Gd, Gd^Es, Ds, Ds^Es, Ds, Ww, Wwt, Wot, Wot
Gs^Fmf, Gll^Fmf, Gll^Fmf, Gll^Fmf, Hh, Hh, Hh, Hh, Hhd^Qhu, Hhd^Qhu, Hhd^Qhu, Hh, Hh, Gs, Ss, Ww, Ww, Hh, Hh, Uu^Qhh, Uu^Qhh, Ds^Qhh, Ds^Qhh, Dd, Hd, Dd, Ds, Dd, Dd, Csz, Csz, Csz, Dd, Ds, Uu, Xu^Qhh, Mm^Xm, Mm, Hh^Ftp, Hh, Gs, Gs, Gd, Ds, Ds^Es, Ds, Ww, Wwt, Wwt, Wot
Gs^Fdf, Gs^Fmf, Gll^Fmf, Hh, Hhd^Qhu, Hhd^Qhu, Hhd^Qhu, Hhd^Qhu, Hd, Hd, Dd^Es, Hhd^Qhu, Hh, Gs, Gs, Ss, Ss, Ww, Ww, Wwf, Wwf, Wwf, Ds^Qhh, Dd^Qhh, Dd^Es, Hd, Dd^Es, Ds, Dd, Dd, Dd, Dd^Es, Dd, Ds, Uu, Xu^Qhh, Mm^Xm, Mm, Hh, Hh, Gs^Es, Gd, Gd, Ds^Es, Ds, Ds^Es, Ds, Ww, Wwt, Wot
Gs^Fdf, Gs^Fmf, Hh, Hh, Hhd^Qhu, Hd, Hd^Es, Hd, Dd, Dd, Dd^Es, Hhd^Qhu, Hhd^Qhu, Hh, Hh, Gs, Gs, Gs, Hh, Wwf, Ds, Wwf, Wwf, Dd^Qhh, Dd^Qhh, Dd, Dd^Qhh, Dd^Es, Hd, Dd, Hd, Ds, Ds^Vht, Ds, Uu, Xu^Qhh, Mm^Xm, Mm, Hh, Gs, Gs^Es, Hhd, Gd, Gd^Es, Ds^Es, Ds^Es, Ds, Ww, Wwt, Wot
Gs^Fdf, Gs^Fmf, Hh, Hhd^Qhu, Hhd^Qhu, Hd, Hd^Es, Hd, Hd, Dd^Vdt, Dd, Dd, Dd, Hhd^Qhu, Hhd^Qhu, Hh, Hh, Hh, Mm^Xm, Uu, Ds, Ds, Wwf, Ds^Qhh, Wwf, Ds^Qhh, Wwf, Dd^Qhh, Dd, Hd, Ds, Ds, Dd, Dd, Uu, Xu^Qhh, Mm^Xm, Hh, Hh, Hh, Gs, Gd, Gd, Gd^Es, Ds^Es, Ds, Ds, Ww, Wwt, Wot
Hh, Hh, Hh, Hh^Fmf, Hhd^Qhu, Hhd^Qhu, Hhd^Qhu, Hhd^Qhu, Hhd^Qhu, Dd, Dd, Dd^Es, Dd^Es, Dd, Hd, Hhd^Qhu, Hh, Mm, Mm^Xm, Xu, Ds, Ds, Dd, Wwf, Ds, Wwf, Ds^Qhh, Dd^Qhh, Dd, Dd^Es, Dd, Dd, Uu, Uu, Uu, Xu^Qhh, Mm^Xm, Mm, Hh^Ftp, Hh, Gs^Es, Gd, Hhd, Gd, Gd^Es, Ds^Es, Ds, Ww, Wwt, Wot
Mm, Mm, Mm, Hh, Hh, Hh, Hh, Hh, Hh, Hhd^Qhu, Hhd^Qhu, Hhd^Qhu, Hhd^Qhu, Dd, Hhd^_ml, Hhd^Qhu, Hhd^Qhu, Hh, Mm^Xm, Xu, Xu, Hd, Hd, Dd^Es, Dd, Wwf, Wwf, Dd^Qhh, Dd^Qhh, Dd, Uu^_mh, Dd, Uu, Uu^Tf, Uu, Xu^Qhh, Mm^Xm, Mm, Hh^Ftp, Hh, Gs^Es, Gd, Hhd, Hhd, Gd^Es, Ds^Es, Ds, Ww, Wwt, Wot
Mm^Xm, Mm^Xm, Mm^Xm, Mm^Xm, Mm^Xm, Mm^Xm, Mm^Xm, Mm^Xm, Mm^Xm, Mm^Xm, Mm^Xm, Hh, Hh, Hhd^Qhu, Hhd^Qhu, Hhd^Qhu, Hhd^Qhu, Hh^Fmf, Hh, Mm^Xm, Mm^Xm, Xu, Xu, Hd, Dd, Dd, Wwf, Wwf, Dd^Qhh, Uu, Uu, Uu, Uu, Uu, Uu, Xu^Qhh, Mm^Xm, Mm, Hh^Ftp, Gs^Ftp, Ds^Ftp, Gd, Hhd, Hhd, Gd^Es, Ds^Es, Ds, Ww, Wwt, Wot
Xu^Qhh, Xu^Qhh, Xu^Qhh, Xu^Qhh, Xu^Qhh, Xu^Qhh, Xu^Qhh, Xu^Qhh, Xu^Qhh, Xu^Qhh, Xu^Qhh, Mm^Xm, Mm^Xm, Hh, Hh, Gs, Gs, Gs^Fmf, Gs^Fmf, Hh^Fmf, Hh, Mm^Xm, Mm^Xm, Xu, Xu, Dd, Wwf, Wwf, Wwf, Dd^Qhh, Xu^Qhh, Xu^Qhh, Xu^Qhh, Xu^Qhh, Xu^Qhh, Xu^Qhh, Mm^Xm, Mm, Hh^Ftp, Gs^Ftp, Gs, Gd, Gd, Gd, Ds^Es, Ds^Vdt, Ds, Ww, Wwt, Wot
Uh^Qhh, Xu^Qhh, Xu^Qhh, Xu^Qhh, Uh, Uh, Uu, Uu, Uu, Uu, Uu, Xu^Qhh, Xu^Qhh, Mm^Xm, Mm^Xm, Hh^Fmf, Hh^Fmf, Gs, Gs^Fmf, Gs^Fmf, Gs, Hh, Hh, Mm^Xm, Mm^Xm, Mm^Xm, Mm, Hd, Wwf, Hd, Mm^Xm, Mm^Xm, Mm^Xm, Mm^Xm, Mm^Xm, Mm^Xm, Mm, Mm, Hh, Gs^Ftp, Gs, Gs, Gs, Gd, Ds^Es, Ds, Ds, Ww, Wwt, Wot
Uh^Qhh, Uh, Uh, Uh, Uh, Uu, Uh, Uu, Uu, Uu, Uu, Uu, Uu, Xu^Qhh, Xu^Qhh, Mm^Xm, Mm^Xm, Hh^Fmf, Hh, Gs, Gs, Gs^Vht, Hh, Mm, Mm, Mm, Mm, Hd, Ww, Hd, Hh, Mm, Mm, Mm, Mm, Mm, Hh^Ftp, Hh, Gs, Gs^Es, Hh, Gs, Gs^Ftp, Gs, Ds^Es, Ds, Ww, Ww, Wwt, Wot
Uh^Qhh, Qxu, Qxu, Qxu^_mh, Qxu, Uh, Uh, Uu, Uu, Uu, Uu, Uu, Uu, Uu, Uu, Xu^Qhh, Xu^Qhh, Mm^Xm, Mm^Xm, Hh, Hh, Gs, Gs, Hh, Hh, Mm, Hh, Hh, Ww, Ss, Ss, Hh, Hh, Mm, Hh, Hh^Ftp, Gs^Es, Hh, Gs, Gs, Gs, Gs, Gs^Ftp, Gs, Ds^Es, Ds, Ww, Wwt, Wwt, Wot
Uu^Qhh, Uh, Qxu, Qxu, Qxu, Qxu, Uh, Uh, Uh, Uu, Ur, Tb^Tf, Uu, Uu, Uu^Vu, Uu, Uh, Xu^Qhh, Xu^Qhh, Mm^Xm, Mm^Xm, Hh, Hh, Gs^Ftp, Gs, Hh, Gs, Ww, Gs, Ww, Ww, Hh, Gs, Hh, Gs, Gs, Gs^Es, Gs, Hh, Gs, Hh^Ftp, Gs^Ftp, Gs^Es, Ds^Es, Ds^Es, Ds, Ww, Wwt, Wot, Wot
Uh^Qhh, Uh, Uh, Qxu, Uh, Uh, Uh, Uh, Uh, Ur, Uh, Ur, Ur, Ur, Ur, Uu, Uu, Uh, Uu, Xu^Qhh, Xu^Qhh, Mm^Xm, Mm^Xm, Hh, Hh, Gs, Ww, Ww, Gs, Gs, Ww, Ww, Ww, Gs, Gs, Gs^Vht, Gs, Hh, Hh, Hh, Gs^Ftp, Gs, Gd^Es, Ds^Es, Ds, Ds, Ww, Wwt, Wot, Wot
Xu^Qhh, Uh, Uh, Uh, Uh, Uh, Uh, Uu, Ur, Ur, Xu, Uh, Xu, Uu, Uu, Ur, Ur, Uu, Uu, Uu, Uu, Xu^Qhh, Xu^Qhh, Mm^Xm, Hh, Hh, Ww, Gs, Gs, Gs, Gs, Ww, Ww, Ds, Ds, Gs, Ds^Es, Gs, Gs, Gs, Gs, Gs, Ds^Es, Ds, Ds, Ww, Wwt, Wwt, Wot, Wot
Uu^Qhh, Uu, Uu, Uu, Uu, Uu, Ur, Ur, Uu, Uu, Xu, Xu, Xu, Xu, Xu, Uu, Uu, Ur, Ur, Uu, Uu, Uu^_mh, Uu^Qhh, Mm^Xm, Hh, Ww, Hh, Gs, Gs, Gs^Ftp, Gs^Ftp, Gs, Gs, Wwt, Ww, Ds, Ds^Es, Gs, Gs, Hh, Hhd, Gd, Ds^Es, Ds, Ds, Ww, Wwt, Wot, Wot, Wot
Uu^Qhh, Uu, Uu, Uu^Ecf, Uu, Ur, Uu, Uu^Ecf, Uu, Uu, Uu, Xu, Uu, Uh, Uh, Xu, Uh, Uu, Uu, Ur, Ur, Uu, Wwf^Qhh, Hh, Ww, Ww, Gs^Ftp, Gs^Ftp, Hh^Ftp, Gs^Ftp, Gs, Gs^Ftp, Gs, Wwt, Wwt, Ww, Ds, Ds^Es, Ds^Es, Gs, Gs, Gd, Ds, Ds, Ww, Ww, Wwt, Wot, Wot, Wot
Uu^Qhh, Uu, Ur^Vdt, Uu, Ur, Ur, Ur, Uu, Ur^Vdt, Uu, Uu, Uu, Tb^Tf, Uu, Xu, Xu, Xu, Uu, Uu, Uu, Wwf, Wwf, Wwf^Qhh, Ww, Hh, Hh, Hh, Hh^Ftp, Hh^Ftp, Gs^Ftp, Gs, Gs, Gs, Gs, Wwt, Wwt, Wwt, Ds, Dd^Ftd, Gs^Ftp, Gs, Ds^Es, Ds, Ds, Ww, Wwt, Wot, Wot, Wot, Wot
Uu^Qhh, Uu, Uu, Ur, Ce, Ce, Ce, Ur, Uu, Uu, Tb^Tf, Tb, Ss, Tb, Xu, Xu, Tb, Tb, Wwf, Uu, Wwf, Uu, Uu^Qhh, Hh, Hh, Hh^Ftp, Hh^Ftp, Hh, Hh, Gs, Gs, Hh, Gs, Ds, Ww, Wwt, Wwt, Ds, Dd, Gs^Ftp, Dd^Es, Ds, Ds, Ww, Wwt, Wwt, Wot, Wot, Wot, Wot
Uu^Qhh, Uu^Ecf, Uu, Ur, Ce, Ke, Ce, Ur, Uu, Uu^Ecf, Tb, Ss, Wwf, Tb^Tf, Xu, Xu, Tb, Wwf, Ss, Wwf, Uu, Uu, Xu^Qhh, Mm^Xm, Hh, Hh^Ftp, Hh, Hh, Gs, Gs^Vht, Gs, Gs, Gs, Ds^Es, Ds, Wwt, Wwt, Ds, Ds, Dd, Dd^Es, Ds^Es, Ww, Ww, Wwt, Wot, Wot, Wot, Wot, Wot
Uu^Qhh, Uu, Ur^Vdt, Ur, Ur, Ce, Ur, Ur, Wwf, Uu, Uu, Tb^Tf, Wwf, Wwf, Wwf, Wwf, Wwf, Wwf, Tb, Tb, Uh, Uh, Xu^Qhh, Mm^Xm, Mm, Hh^Ftp, Hh^Ftp, Hh, Gs^Ftp, Gs, Gs, Hh, Gs, Gd^Es, Ds, Wwt, Wwt, Wwt, Ds, Dd, Ds^Vht, Ds, Ww, Wwt, Wot, Wot, Wot, Wot, Wot, Wot
Uu^Qhh, Uu, Uu, Uu, Uu, Ur, Uu, Wwf^Bw\, Wwf^Xo, Wwf, Wwf, Wwf, Uu, Uu, Xu, Uu, Uu, Uu, Uh, Xu^Qhh, Xu^Qhh, Uh, Xu^Qhh, Mm^Xm, Mm, Hh^Ftp, Hh^Ftp, Gs^Ftp, Gs^Ftp, Gs, Hh^Ftp, Gs, Gs, Ds^Es, Ds^Es, Ds, Wwt, Wwt, Wwt, Ds, Ds, Ds, Wwt, Wwt, Wot, Wot, Wot, Wot, Wot, Wot
Uu^Qhh, Uu, Uu, Uu^Ecf, Uu, Uu, Uu, Wwf, Ss, Ss, Tb, Uu, Uu, Xu, Uh, Uu, Uh, Uh, Xu^Qhh, Xu^Qhh, Xu^Qhh, Xu^Qhh, Xu^Qhh, Mm^Xm, Hh, Hh^Ftp, Gs, Gs, Hh, Hh, Hh^Ftp, Gs^Ftp, Gs^Ftp, Gs, Ds^Es, Ds, Ds, Wwt, Wot, Wwt, Wwt, Wwt, Wwt, Wwt, Wot, Wot, Wot, Wot, Wot, Wot
Uu^Qhh, Uu^Qhh, Uu^Qhh, Uu^Qhh, Uu^Qhh, Uu^Qhh, Wwf^Qhh, Wwf^Qhh, Tb^Qhh, Tb^Qhh, Xu^Qhh, Xu^Qhh, Xu^Qhh, Xu^Qhh, Xu^Qhh, Uh^Qhh, Xu^Qhh, Uh^Qhh, Xu^Qhh, Xu^Qhh, Xu^Qhh, Xu^Qhh, Mm^Xm, Mm^Xm, Hh, Hh^Ftp, Hh, Hh, Hh^Ftp, Hh^Ftp, Gs, Gs^Ftp, Ds^Ftp, Gs, Ds^Es, Ds, Wwt, Wwt, Wot, Wot, Wwt, Wwt, Wot, Wot, Wot, Wot, Wot, Wot, Wot, Wot
