border_size=1
usage=map

Hh, Hh^Fmf, Hh^Fmf, Mm, Mm, Hh, Hh, Hh, Mm, Hh, Md, Md, Md, Hh, Hh, Gs, Gs, Gs, Hh, Hh, Mm, Mm, Mm, Hh, Mm, Mm, Mm, Mm, Hh, Hh, Gs^Fmf, Gs, Gs^Es, Gs, Gs, Gs, Ds^Es, Ds^Es, Ds, Ds, Ww, Ww, Wwt, Wot, Wot, Wot, Wot, Wot, Wot, Wot
Gs, Hh^Fmf, Mm, Hh^Fmf, Hh, Hh, Hhd, Hhd, Mm, Mm, Md, Md, Md, Md, Hh^Vht, Hh, Hh, Gs, Gs, Hh^Fmf, Hh^Fmf, Mm, Hh, Mm, Hh^Fmf, Hh^Fmf, Hh, Hh, Gs^Fmf, Gs^Fmf, Gs, Gs, Gs, Gs^Es, Ds^Es, Ds^Es, Ds, Ds, Ww, Ww, Ww, Ww, Wwt, Wot, Wot, Wot, Wot, Wot, Wot, Wot
Gs, Hh^Fmf, Hh, Hh, Hhd, Hhd, Hd, Hhd, Hhd, Hhd, Hhd, Hhd, Hhd, Md, Md, Md, Hh, Gs, Gs, Gs^Fmf, Gs^Es, Hh, Gs, Hh^Fmf, Gs, Gs, Gs, Gs, Gs, Gs, Hh, Gs, Gs^Vht, Gs, Ds, Ds^Es, Ds, Ww, Ww, Ww, Wwt, Wwt, Wot, Wot, Wot, Wot, Wot, Wot, Wot, Wot
Hh, Mm, Hh, Hhd, Hhd, Hhd, Hd, Hd, Hd, Hd, Hd, Hhd, Hd, Hhd, Hh, Md, Md, Hh, Hh, Gs, Gs^Es, Gs^Es, Hh, Gs, Gs, Dd, Dd^Es, Dd, Gs, Hh, Gs, Gs, Gd, Gd, Ds^Es, Ds, Ww, Ww, Wwt, Wwt, Wot, Wot, Wot, Wot, Wot, Wot, Wot, Wot, Wot, Wot
Hh, Hh^Ftp, Hhd, Hhd, Hhd^Es, Hd, Dd^Es, Dd^Es, Dd^Es, Dd^Es, Hd, Hd, Hhd, Hhd, Hh, Hh^Ftp, Hh^Ftp, Md, Hh, Hh, Gs^Ftp, Hh, Hh, Gs, Dd, Dd^Es, 1 Dd, Dd, Gs, Gs, Gs, Gs^Es, Ds, Ds, Ds, Ds, Ww, Ww, Wwt, Wwt, Wot, Wot, Wot, Wot, Wot, Wot, Wot, Wot, Wot, Wot
Hh, Hh^Ftp, Hhd, Hhd^Vht, Hd, Hd, Hd, Hd^Es, Hd, Dd^Es, Hd^Es, Hd, Hhd, Hhd, Mm, Hh^Ftp, Hh, Md, Md, Hh, Gs^Ftp, Gs^Ftp, Gs, Gs, Gs, Dd, Dd, Ss, Wwt, Gs, Wwt, Gs, Wwt, Ds, Ww, Ww, Wwt, Wwt, Wot, Wot, Wot, Wot, Wot, Wot, Wot, Wot, Wot, Wot, Wot, Wot
Mm, Hhd, Hhd, Hhd, Hhd, Hhd, Hhd, Hd^Es, Hhd, Hd, Hhd, Hd, Hd, Hhd, Mm, Hh, Hh, Md, Md, Hh, Hh, Hh, Hh, Gs, Gs, Dd, Gs, Dd, Wwt, Wwt, Wwt, Wwt, Wwt, Wwt, Wwt, Wwt, Wwt, Wwt, Wot, Wot, Wot, Wot, Wot, Wot, Wot, Wot, Wot, Wot, Wot, Wot
Mm, Md, Md, Md, Md, Hhd, Md, Hhd, Hhd, Hhd, Hhd, Hhd, Hhd, Hhd, Hhd, Mm, Mm, Hh, Hh^Es, Hh, Gs^Es, Hh, Gs, Gs, Ww, Gs, Ww, Ww, Ww, Ww, Gs, Ww, Ww, Wwt, Ww, Wwt, Wwt, Wwt, Wwt, Wot, Wot, Wot, Wot, Wot, Wot, Wot, Wot, Wot, Wot, Wot
Hh, Hh, Hh, Hh, Hh, Md, Hh, Md, Md, Md, Md, Md, Md, Md, Mm, Mm, Hh, Hh^Fmf, Hh, Hh^Es, Gs, Gs, Gs, Gs, Ww, Ww, Ww, Ww, Gs, Gs, Gs^Es, Ds, Ds, Ds, Ds, Ww, Ww, Wwt, Wwt, Wwt, Wot, Wot, Wot, Wot, Wot, Wot, Wot, Wot, Wot, Wot
Gs, Gs, Gs, Gs, Gs, Hh, Hh, Hh, Hh, Hh, Hh, Hh, Hh, Hh, Hh, Hh, Gs^Es, Hh, Gs, Gs^Es, Gs, Ss, Ww, Ww, Ww, Gs, Gs, Gs, Gs^Es, Gs, Gs^Vht, Ds^Es, Ds, Ds^Es, Ds^Es, Ds, Ds, Ww, Ww, Wwt, Wwt, Wot, Wot, Wot, Wot, Wot, Wot, Wot, Wot, Wot
Ww, Ww, Ww, Ss, Ww, Gs, Gs, Gs, Gs, Gs, Gs, Gs, Gs, Hh^Fmf, Gs^Fmf, Gs, Ww, Gs, Ww, Ww, Ww, Ww, Gs, Ww, Gs^Es, Gs^Es, Hh, Hh, Hh, Gs, Hh, Gs, Gs, Gd, Gd, Ds, Ds, Ww, Ww, Wwt, Wwt, Wwt, Wwt, Wot, Wot, Wot, Wot, Wot, Wot, Wot
Ss, Ww, Ss, Ww, Ww, Ww, Ww, Ww, Ww, Ss, Ww, Ss, Ww, Gs, Ww, Ww, Ww, Ww, Ww, Ww, Ww, Ww, Gs^Es, Gs^Es, Hh, Hh, Mm, Hh, Mm, Hh, Hh, Gs^Ftp, Hh^Ftp, Gs, Gd, Ds^Es, Ds^Es, Ds, Ds, Ww, Ww, Wwt, Wwt, Wwt, Wot, Wot, Wot, Wot, Wot, Wot
Ss, Ss, Ss, Ss, Ss, Ww, Ss, Ww, Ww^Ewl, Ww, Wo, Ww, Wo, Ww, Ww, Ss, Gs^Ftp, Ww, Gs, Gs, Gs, Gs^Ftp, Hh^Ftp, Hh, Mm, Mm, Mm, Mm, Mm, Mm, Mm, Mm, Mm, Hh, Gs^Ftp, Gd^Es, Gd^Es, Ds^Es, Ds^Es, Ds, Ww, Wwt, Wwt, Wwt, Wwt, Wot, Wot, Wot, Wot, Wot
Gs, Gs, Gs, Gs, Gs, Ss, Gs, Ss, Ss, Ww, Wo, Wo, Ww, Ww, Ss, Gs^Ftp, Gs^Ftp, Gs^Ftp, Gs^Ftp, Gs^Ftp, Hh^Es, Hh^Es, Mm, Mm, Xu, Xu, Xu, Xu, Xu, Xu, Xu, Mm, Mm, Hh^Ftp, Hh^Ftp, Gs^Ftp, Gs, Ds^Es, Ds, Ds, Ds, Ww, Ww, Wwt, Wwt, Wwt, Wot, Wot, Wot, Wot
Gs, Gs^Es, Gs, Hh, Hh, Gs, Ss, Ss, Ss, Ww, Ww, Wo, Ww, Ss, Gs^Ftp, Gs^Ftp, Hh^Ftp, Gs^Ftp, Hh^Ftp, Hh^Ftp, Mm, Mm, Xu, Xu, Uu, Uu, Uu^Tf, Uu, Uu, Uu, Uu, Xu, Xu, Mm, Mm, Hh^Ftp, Hh^Ftp, Gs, Gs, Ds^Es, Ds^Es, Ds, Ds, Ww, Wwt, Wwt, Wot, Wot, Wot, Wot
Gs, Gs^Vht, Gs^Es, Gs, Gs, Gs, Gs, Gs, Gs, Ss, Ww, Ww, Ss, Gs^Ftp, Hh^Ftp, Hh^Ftp, Mm, Hh^Ftp, Mm, Mm, Xu, Xu, Uu, Uu, Uu, Uu, Uu, Uu, Dd, Uu, Dd, Uu, Uu, Xu, Xu, Mm, Mm, Hh, Gs, Gd, Ds, Ds^Es, Ds^Es, Ww, Ww, Wwt, Wwt, Wot, Wot, Wot
Gs, Gs^Es, Gs^Fmf, Gs, Ss, Gs^Ftp, Ss, Gs^Ftp, Ss, Gs, Gs, Ww, Ww, Ss, Ss, Hh^Ftp, Mm, Mm, Mm, Xu, Uu, Uu, Uu, Uu, Dd, Dd, Dd, Dd, Dd, Dd, Dd, Dd, Dd^Vht, Uu, Uu, Xu, Mm, Hh, Gs, Gd, Gd, Ds^Es, Ds^Es, Ds, Ds, Ww, Wwt, Wot, Wot, Wot
Gs, Gs, Gs^Es, Gs, Gs, Ss, Gs, Ss, Gs, Gs, Hh, Gs^Ftp, Gs^Ftp, Ww, Ss, Hh^Ftp, Hh^Ftp, Mm, Mm, Xu, Uu, Uu, Dd, Dd, Dd, Dd^Es, Dd, Dd, Dd, Dd, Csz, Dd, Dd, Dd, Uu, Xu, Mm, Hh, Hh, Gs, Gs^Vht, Gd, Ds^Es, Ds, Ds, Ww, Ww, Wwt, Wot, Wot
Gs^Fmf, Gs^Fmf, Gs^Fmf, Gs^Fmf, Gs^Fmf, Gs, Gs, Gs, Hh, Hh, Hhd, Hh, Gs, Ww, Ww, Ss, Ss, Hh^Ftp, Mm, Xu, Uu, Dd, Dd^Es, Dd, Dd, Dd, Dd^Vht, Dd, Dd, Csz, 2 Csz^Ksy, Csz, Dd, Dd, Uu, Xu, Mm, Mm, Hh^Ftp, Gs, Gs, Gd, Gd^Es, Ds, Ds^Es, Ds, Ww, Wwt, Wot, Wot
Gs^Fmf, Gll^Fmf, Gll^Fmf, Gll^Fmf, Hh, Hh, Hh, Hh, Hhd, Hhd, Hhd, Hh, Hh, Gs, Ss, Ww, Ww, Hh, Hh, Uu, Uu, Dd, Dd, Dd, Dd, Dd, Dd, Dd, Dd, Csz, Csz, Csz, Dd, Dd, Uu, Xu, Mm, Mm, Hh^Ftp, Hh, Gs, Gs, Gd, Ds, Ds^Es, Ds, Ww, Wwt, Wwt, Wot
Gs^Fdf, Gs^Fmf, Gll^Fmf, Hh, Hhd, Hhd, Hhd, Hhd, Hd, Hd, Dd^Es, Hhd, Hh, Gs, Gs, Ss, Ss, Ww, Ww, Ww, Ww, Ww, Dd, Dd, Dd^Es, Dd, Dd^Es, Dd, Dd, Dd, Dd, Dd^Es, Dd, Dd, Uu, Xu, Mm, Mm, Hh, Hh, Gs^Es, Gd, Gd, Ds^Es, Ds, Ds^Es, Ds, Ww, Wwt, Wot
Gs^Fdf, Gs^Fmf, Hh, Hh, Hhd, Hd, Hd^Es, Hd, Dd, Dd, Dd^Es, Hhd, Hhd, Hh, Hh, Gs, Gs, Gs, Hh, Ww, Dd, Ww, Ww, Dd, Dd, Dd, Dd, Dd^Es, Dd, Dd, Dd, Dd, Dd^Vht, Dd, Uu, Xu, Mm, Mm, Hh, Gs, Gs^Es, Hhd, Gd, Gd^Es, Ds^Es, Ds^Es, Ds, Ww, Wwt, Wot
Gs^Fdf, Gs^Fmf, Hh, Hhd, Hhd, Hd, Hd^Es, Hd, Hd, Dd^Vdt, Dd, Dd, Dd, Hhd, Hhd, Hh, Hh, Hh, Mm, Uu, Dd, Dd, Ww, Dd, Ww, Dd, Ww, Dd^Es, Dd, Dd, Dd, Dd, Dd, Dd, Uu, Xu, Mm, Hh, Hh, Hh, Gs, Gd, Gd, Gd^Es, Ds^Es, Ds, Ds, Ww, Wwt, Wot
Hh, Hh, Hh, Hh^Fmf, Hhd, Hhd, Hhd, Hhd, Hhd, Dd, Dd, Dd^Es, Dd^Es, Dd, Hd, Hhd, Hh, Mm, Mm, Xu, Dd, Dd, Dd, Ww, Dd, Ww, Dd, Dd, Dd, Dd^Es, Dd, Dd, Uu, Uu, Uu, Xu, Mm, Mm, Hh^Ftp, Hh, Gs^Es, Gd, Hhd, Gd, Gd^Es, Ds^Es, Ds, Ww, Wwt, Wot
Mm, Mm, Mm, Hh, Hh, Hh, Hh, Hh, Hh, Hhd, Hhd, Hhd, Hhd^Es, Dd, Hhd, Hhd, Hhd, Hh, Mm, Xu, Xu, Dd, Dd, Dd^Es, Dd, Ww, Ww, Dd, Dd, Dd, Uu, Dd, Uu, Uu^Tf, Uu, Xu, Mm, Mm, Hh^Ftp, Hh, Gs^Es, Gd, Hhd, Hhd, Gd^Es, Ds^Es, Ds, Ww, Wwt, Wot
Mm, Mm, Mm, Mm, Mm, Mm, Mm, Mm, Mm, Mm, Mm, Hh, Hh, Hhd, Hhd, Hhd^Fmf, Hhd^Fmf, Hh^Fmf, Hh, Mm, Mm, Xu, Xu, Dd, Dd, Dd, Ww, Ww, Dd, Uu, Uu, Uu, Uu, Uu, Uu, Xu, Mm, Mm, Hh^Ftp, Gs^Ftp, Ds^Ftp, Gd, Hhd, Hhd, Gd^Es, Ds^Es, Ds, Ww, Wwt, Wot
Xu, Xu, Xu, Xu, Xu, Xu, Xu, Xu, Xu, Xu, Xu, Mm, Mm, Hh, Hh, Gs, Gs, Gs^Fmf, Gs^Fmf, Hh^Fmf, Hh, Mm, Mm, Xu, Xu, Dd, Ww, Ww, Ww, Dd, Xu, Xu, Xu, Xu, Xu, Xu, Mm, Mm, Hh^Ftp, Gs^Ftp, Gs, Gd, Gd, Gd, Ds^Es, Ds^Vdt, Ds, Ww, Wwt, Wot
Uh, Xu, Xu, Xu, Uh, Uh, Uu, Uu, Uu, Uu, Uu, Xu, Xu, Mm, Mm, Hh^Fmf, Hh^Fmf, Gs, Gs^Fmf, Gs^Fmf, Gs, Hh, Hh, Mm, Mm, Mm, Mm, Hh, Ww, Mm, Mm, Mm, Mm, Mm, Mm, Mm, Mm, Mm, Hh, Gs^Ftp, Gs, Gs, Gs, Gd, Ds^Es, Ds, Ds, Ww, Wwt, Wot
Uh, Uh, Uh, Uh, Uh, Uu, Uh, Uu, Uu, Uu, Uu, Uu, Uu, Xu, Xu, Mm, Mm, Hh^Fmf, Hh, Gs, Gs, Gs^Vht, Hh, Mm, Mm, Mm, Mm, Hh, Ww, Hh, Hh, Mm, Mm, Mm, Mm, Mm, Hh^Ftp, Hh, Gs, Gs^Es, Hh, Gs, Gs^Ftp, Gs, Ds^Es, Ds, Ww, Ww, Wwt, Wot
Uh, Qxu, Qxu, Qxu, Qxu, Uh, Uh, Uu, Uu, Uu, Uu, Uu, Uu, Uu, Uu, Xu, Xu, Mm, Mm, Hh, Hh, Gs, Gs, Hh, Hh, Mm, Hh, Hh, Ww, Ss, Ss, Hh, Hh, Mm, Hh, Hh^Ftp, Gs^Es, Hh, Gs, Gs, Gs, Gs, Gs^Ftp, Gs, Ds^Es, Ds, Ww, Wwt, Wwt, Wot
Uu, Uh, Qxu, Qxu, Qxu, Qxu, Uh, Uh, Uh, Uu, Uu, Uu^Tf, Uu, Uu, Uu^Vu, Uu, Uh, Xu, Xu, Mm, Mm, Hh, Hh, Gs^Ftp, Gs, Hh, Gs, Ww, Gs, Ww, Ww, Hh, Gs, Hh, Gs, Gs, Gs^Es, Gs, Hh, Gs, Hh^Ftp, Gs^Ftp, Gs^Es, Ds^Es, Ds^Es, Ds, Ww, Wwt, Wot, Wot
Uh, Uh, Uh, Qxu, Uh, Uh, Uh, Uh, Uh, Uu, Uh, Uu, Uu, Uu, Uu, Uu, Uu, Uh, Uu, Xu, Xu, Mm, Mm, Hh, Hh, Gs, Ww, Ww, Gs, Gs, Ww, Ww, Ww, Gs, Gs, Gs^Vht, Gs, Hh, Hh, Hh, Gs^Ftp, Gs, Gd^Es, Ds^Es, Ds, Ds, Ww, Wwt, Wot, Wot
Xu, Uh, Uh, Uh, Uh, Uh, Uh, Uu, Uu, Uu, Xu, Uh, Xu, Uu, Uu, Uu, Uu, Uu, Uu, Uu, Uu, Xu, Xu, Mm, Hh, Hh, Ww, Gs, Gs, Gs, Gs, Ww, Ww, Ds, Ds, Gs, Ds^Es, Gs, Gs, Gs, Gs, Gs, Ds^Es, Ds, Ds, Ww, Wwt, Wwt, Wot, Wot
Uu, Uu, Uu, Uu, Uu, Uu, Uu, Uu, Uu, Uu, Xu, Xu, Xu, Xu, Xu, Uu, Uu, Uu, Uu, Uu, Uu, Uu, Uu, Mm, Hh, Ww, Hh, Gs, Gs, Gs^Ftp, Gs^Ftp, Gs, Gs, Wwt, Ww, Ds, Ds^Es, Gs, Gs, Hh, Hhd, Gd, Ds^Es, Ds, Ds, Ww, Wwt, Wot, Wot, Wot
Uu, Uu, Uu, Uu^Ecf, Uu, Uu, Uu, Uu^Ecf, Uu, Uu, Uu, Xu, Uu, Uh, Uh, Xu, Uh, Uu, Uu, Uu, Uu, Uu, Ww, Hh, Ww, Ww, Gs^Ftp, Gs^Ftp, Hh^Ftp, Gs^Ftp, Gs, Gs^Ftp, Gs, Wwt, Wwt, Ww, Ds, Ds^Es, Ds^Es, Gs, Gs, Gd, Ds, Ds, Ww, Ww, Wwt, Wot, Wot, Wot
Uu, Uu, Ur^Vdt, Uu, Ur, Ur, Ur, Uu, Ur^Vdt, Uu, Uu, Uu, Uu, Uu, Xu, Xu, Xu, Uu, Uu, Uu, Ww, Ww, Ww, Ww, Hh, Hh, Hh, Hh^Ftp, Hh^Ftp, Gs^Ftp, Gs, Gs, Gs, Gs, Wwt, Wwt, Wwt, Ds, Dd^Ftd, Gs^Ftp, Gs, Ds^Es, Ds, Ds, Ww, Wwt, Wot, Wot, Wot, Wot
Uu, Uu, Uu, Ur, Ce, Ce, Ce, Ur, Uu, Uu, Uu, Uu, Ww, Uu, Xu, Xu, Uu, Uu, Ww, Uu, Ww, Uu, Uu, Hh, Hh, Hh^Ftp, Hh^Ftp, Hh, Hh, Gs, Gs, Hh, Gs, Ds, Ww, Wwt, Wwt, Ds, Dd, Gs^Ftp, Dd^Es, Ds, Ds, Ww, Wwt, Wwt, Wot, Wot, Wot, Wot
Uu, Uu^Ecf, Uu, Ur, Ce, Ke, Ce, Ur, Uu, Uu^Ecf, Uu, Ww, Ww, Uu, Xu, Xu, Uu, Ww, Uu, Ww, Uu, Uu, Xu, Mm, Hh, Hh^Ftp, Hh, Hh, Gs, Gs^Vht, Gs, Gs, Gs, Ds^Es, Ds, Wwt, Wwt, Ds, Ds, Dd, Dd^Es, Ds^Es, Ww, Ww, Wwt, Wot, Wot, Wot, Wot, Wot
Uu, Uu, Ur^Vdt, Ur, Ur, Ce, Ur, Ur, Ww, Uu, Uu, Uu, Ww, Ww, Ww, Ww, Ww, Ww, Uu, Uu, Uh, Uh, Xu, Mm, Mm, Hh^Ftp, Hh^Ftp, Hh, Gs^Ftp, Gs, Gs, Hh, Gs, Gd^Es, Ds, Wwt, Wwt, Wwt, Ds, Dd, Ds^Vht, Ds, Ww, Wwt, Wot, Wot, Wot, Wot, Wot, Wot
Uu, Uu, Uu, Uu, Uu, Ur, Uu, Ww^Bw\, Ww^Xo, Ww, Ww, Ww, Uu, Uu, Xu, Uu, Uu, Uu, Uh, Xu, Xu, Uh, Xu, Mm, Mm, Hh^Ftp, Hh^Ftp, Gs^Ftp, Gs^Ftp, Gs, Hh^Ftp, Gs, Gs, Ds^Es, Ds^Es, Ds, Wwt, Wwt, Wwt, Ds, Ds, Ds, Wwt, Wwt, Wot, Wot, Wot, Wot, Wot, Wot
Uu, Uu, Uu, Uu^Ecf, Uu, Uu, Uu, Ww, Ss, Ss, Uu, Uu, Uu, Xu, Uh, Uu, Uh, Uh, Xu, Xu, Xu, Xu, Xu, Mm, Hh, Hh^Ftp, Gs, Gs, Hh, Hh, Hh^Ftp, Gs^Ftp, Gs^Ftp, Gs, Ds^Es, Ds, Ds, Wwt, Wot, Wwt, Wwt, Wwt, Wwt, Wwt, Wot, Wot, Wot, Wot, Wot, Wot
Uu, Uu, Uu, Uu, Uu, Uu, Ww, Ww, Uu, Uu, Xu, Xu, Xu, Xu, Xu, Uh, Xu, Uh, Xu, Xu, Xu, Xu, Mm, Mm, Hh, Hh^Ftp, Hh, Hh, Hh^Ftp, Hh^Ftp, Gs, Gs^Ftp, Ds^Ftp, Gs, Ds^Es, Ds, Wwt, Wwt, Wot, Wot, Wwt, Wwt, Wot, Wot, Wot, Wot, Wot, Wot, Wot, Wot
