border_size=1
usage=map

Mm, Mm, Mm, Mm, Mm, Mm, Mm, Mm, Mm, Mm, Mm, Mm, Hh^Ftp, Hh^Ftp, Hh^Ftp, Gs^Ftp, Gs, Wot, Wot, Wwt, Hh^Ftp, Gd, Hh, Hh, Hh^Fms, Gd^Fms, Hh^Fms, Gs, Gs, Gd, Gd^Es, Gd, Hhd, Hhd, Hhd, Hhd, Md, Hhd, Hhd, Hhd, Hhd, Md, Md, Hhd, Hhd, Hhd, Md, Md, Hhd, Uh, Uh, Uh, Uh, Xu, Xu, Xu, Xu, Xu, Xu, Xu, Xu, Xu
Mm, Mm, Mm, Mm, Mm, Mm, Mm, Hh^Fms, Mm, Mm, Mm, Mm, Mm, Hh^Ftp, Hh^Vht, Gs^Ftp, Gs, Wwt, Wwt, Wwt, Ww, Hh^Ftp, Mm, Mm, Mm, Hh, Hh^Fms, Gs^Fds, Hh^Fds, Gs, Gs, Gd, Hhd, Hhd, Hhd, Hhd, Hhd, Hhd, Md, Hhd, Hhd, Md, Hhd^Fmf, Hhd^Fmf, Hhd^Fmf, Md, Md, Hhd, Uh, Uh, Uh, Uh, Uh, Uh, Uh, Uh, Uh, Uh, Uh, Xu, Xu, Xu
Mm, Mm, Mm, Mm, Mm, Mm, Mm, Hh^Fms, Mm, Mm, Hh, Mm, Mm, Mm, Mm, Hh^Ftp, Hh^Ftp, Gs^Es, Gs^Es, Wwt, Ww, Hh^Ftp, Hh^Ftp, Mm, Mm, Mm, Mm, Hh, Mm, Hh^Fds, Gs^Fds, Gd, Gd, Hhd, Gd, Hhd, Hhd, Hhd, Hhd, Md, Hhd, Hhd, Md, Ce^Fmf, Md, Md, Hhd, Hhd, Uh, Uh^Vd, Uh, Uh, Ql, Ce, Ql, Ql, Uh, Uh, Uh, Uh, Uh, Uh
Mm, Mm, Hh^Fms, Hh^Fms, Hh^Fds, Hh^Vd, Mm, Mm, Md, Hh, Md, Hh, Md, Hh, Hh^Fds, Hh, Hh, Hh^Ftp, Gs^Ftp, Wwt, Wwt, Ww, Hh^Ftp, Hh^Ftp, Hh^Ftp, Mm, Mm, Mm, Mm, Hh^Fms, Hh^Fds, Gs, Gs, Gd, Gd^Es, Gd, Hhd, Hhd, Hhd, Md, Hhd, Md, Md, Hhd, Md, Md, Hhd, Uh, Ch, Uh, Uh, Ql, Ql, Ql, Ql, Ql, Ql, Ql, Uh, Uh, Uh, Uh
Hh^Fms, Mm, Mm, Mm, Mm, Hh, Mm, Md, Md, Md, Md, Md, Md, Md, Md, Md, Md, Hh, Hh, Gs, Wwt, Ww, Ww, Gs^Ftp, Gs^Ftp, Hh^Vht, Mm, Mm, Mm, Hh^Fms, Hh^Fms, Gs^Fms, Gs^Fms, Gs, Gd^Es, Gd, Hhd, Hhd^Vd, Hhd, Hhd, Hhd, Hhd, Hhd, Hhd, Md, Md, Hhd, Ch, Kh, Ce, Uh, Ql, Ql, Ql, Ql, Ql, Ql, Ql, Ql, Ql, Ql, Ql
Hh^Fms, Hh^Fms, Md, Mm, Mm, Mm, Xu, Xu, Xu, Xu, Xu, Xu, Xu, Xu, Xu, Md, Mm, Hh, Hh^Ftp, Gs^Ftp, Gs, Wwt, Ww, Gs^Ftp, Gs^Ftp, Hh^Ftp, Mm, Mm, Mm, Mm, Mm, Hh^Fms, Gs^Fms, Gs, Gs, Gd, Gd, Hhd, Hhd^Es, Hhd^Es, Hhd, Md, Hhd, Md, Hhd, Md, Hhd, Ch, Ce, Ce, Uh, Uh, Ql, Ql, Ql, Ql, Ql, Ql, Ql, Ql, Ql, Ql
Md, Md, Md, Md, Uu, Uu, Uu, Uu, Uu, Uu, Uu, Uu, Uu, Uu, Uu, Xu, Mm, Mm, Hh^Ftp, Hh^Ftp, Gs, Wwt, Wwt, Ww, Gs, Hh^Ftp, Mm, Mm, Mm, Mm, Hh, Hh^Fms, Hh^Fms, Gs^Fds, Gs, Gs^Es, Gd, Hhd, Hhd, Hhd, Md, Hhd, Hhd, Hhd, Hhd, Md, Hhd, Uh, Uh, Uh, Uh, Ql, Ql, Ql, Ql, Ql, Ql, Ql, Ql, Ql, Ql, Ql
Md, Md, Xu, Xu, Uu, Uu, Uu^Tf, Uu, Uu, Uu, Ur, Ur^Vdt, Ur, Uu, Ur, Uu, Hh, Mm, Hh, Hh, Gs^Ftp, Gs, Wwt, Ww, Gs^Es, Hh^Ftp, Mm, Mm, Mm, Mm, Mm, Mm, Mm, Hh^Fms, Gs^Fms, Gs, Gd, Hhd, Hhd^Fmf, Hhd^Fmf, Hhd^Fmf, Hhd, Md, Ce, Md, Md, Md, Hhd, Uh, Uh, Uh, Uh, Uh, Ce, Uh, Ql, Ql, Ql, Ql, Ql, Uh, Uh
Xu, Xu, Uh, Uu, Uh, Uu, Uu, Uu, Ur, Ur, Uu, Ur, Ur^Vdt, Ur, Uu, Ur, Hh, Hh, Hh, Hh, Gs, Gs, Wwt, Ww, Gs^Es, Hh, Mm, Mm, Mm, Mm, Mm, Mm, Mm, Hh^Fms, Hh^Fms, Gs, Gd, Gd, Hhd, Hhd^Fmf, Hhd, Hhd, Hhd, Hhd, Hhd^Fmf, Hhd, Md, Hhd, Uh, Uh, Uh, Uh, Uh, Uh, Ql, Ql, Ql, Ql, Ql, Ql, Uh, Uh
Xu, Xuc, Uh, Uu, Uu, Uu, Uu, Uu, Ce, Uu, Uu, Uu, Uu, Uu, Uu, Uu, Mm, Hh, Hh^Ftp, Hh, Gs, Ww^Bw\, Ww^Bw\, Ww, Gs, Hh, Hh, Mm, Hh^Vc, Mm, Mm, Mm, Mm, Mm, Hh^Fms, Gs^Fds, Gs, Gd, Hhd, Md, Hhd, Hhd, Hhd, Hhd^Fmf, Hhd^Fmf, Hhd^Fmf, Hhd, Hhd, Ce, Uh, Uh, Uh^Vd, Uh, Uh, Uh, Uh, Uh, Uh, Uh, Uh, Uh, Uh
Xu, Xuc, Uh, Uu, Uu^Ecf, Uu, Uu, Ce, 3 Ke, Ce, Uu, Uh, Uu^Ecf, Uu, Uu, Xu, Mm, Mm, Hh^Ftp, Gs, Ww, Wwt, Ww, Gs, Gs, Hh, Hh, Hh, Hh, Hh, Hh, Mm, Hh, Mm, Hh^Fms, Gs^Fms, Gs, Gd, Gd, Hhd, Hhd, Md, Hhd^Vd, Md, Md, Hhd, Hhd, Md, Hhd, Hhd, Hhd, Uh, Uh, Uh, Uh, Uh, Uh, Uh, Uh, Uh, Xu, Uh
Xu, Uh, Uu, Uu, Uu, Uu, Uu, Ce, Ce, Ce, Uu, Uu, Uu, Uu, Uu, Xu, Mm, Hh^Ftp, Hh^Ftp, Gs, Ww, Wot, Ww, Gs, Gs^Ftp, Hh, Mm, Hh, Hh, Hh, Hh, Hh, Mm, Mm, Mm, Hh^Fms, Hh^Fms, Gs, Gd, Hhd, Hhd, Hhd, Hhd, Hhd, Md, Hhd, Hhd, Md, Md, Md, Hhd, Hhd, Hhd, Uh, Xu, Xu, Xu, Xu, Xu, Xu, Xu, Xu
Xu, Uu, Ur^Vdt, Uu, Uu, Xu, Uu, Uu, Ur, Uu, Uu, Xu, Uu, Uu, Uu, Xu, Mm, Hh^Ftp, Gs^Ftp, Gs, Ww, Wwt, Ww, Gs^Ftp, Hh^Ftp, Hh, Mm, Mm, Mm, Mm, Mm, Hh, Hh, Mm, Hh, Mm, Hh, Gs, Gs, Gd, Hhd, Md, Hhd, Hhd, Hhd, Md, Hhd^Fmf, Hhd, Hhd, Md, Hhd, Md, Md, Hhd, Xu, Xu, Xu, Xu, Xu, Xu, Xu, Xu
Xu, Uu, Uu, Ur, Ur, Uu, Ur, Ur, Uu, Ur, Ur, Uu, Ur, Ur^Vdt, Uu, Xu, Mm, Hh^Ftp, Gs^Ftp, Ww, Wwt, Wot, Ww, Gs^Ftp, Hh^Ftp, Hh, Mm, Mm, Mm, Mm, Mm, Mm, Mm, Mm, Hh^Fms, Hh, Hh^Fms, Hh^Fms, Hhd, Gd, Hhd, Hhd, Hhd, Hhd, Hhd, Hhd^Fmf, Hhd^Fmf, Md, Md, Hhd, Hhd, Hhd, Hhd, Md, Xu, Xu, Uh, Xu, Uu, Uh, Xu, Xu
Xu, Xu, Uu, Uu, Uu, Ur, Uu, Uu, Uh, Uu, Uu, Ur, Uu, Uu, Uh, Xu, Mm, Hh^Ftp, Gs, Ww, Wot, Ww, Gs^Vht, Gs^Ftp, Hh, Hh, Mm, Mm, Mm, Mm, Mm, Mm, Mm, Mm, Mm, Mm, Mm, Mm, Md, Md, Md, Md, Md, Hhd, Md, Md, Md, Md, Md, Hhd, Md, Md, Hhd, Md, Xu, Xu, Uu, Uu, Ur, Uu, Uu^Tf, Xu
Uu, Uu, Uu, Uu, Ce, Ce, Ce, Uu, Uu, Uu^Tf, Uu, Uu, Uh, Xu, Xu, Xu, Mm, Hh^Ftp, Gs, Ww, Wot, Ww, Hh^Ftp, Hh, Mm, Mm, Xu, Xu, Xu, Xu, Xu, Xu, Xu, Xu, Xu, Xu, Xu, Xu, Xu, Xu, Xu, Xu, Uu, Ur, Uu, Xu, Xu, Xu, Xu, Xu, Xu, Xu, Uu, Xu, Xu, Xu, Uu, Uu, Uu, Ur, Uu, Xu
Ur, Uu^Ecf, Ur, Ur, Ce, 2 Ke, Ce, Uu, Uu, Uu^Ecf, Uu, Xu, Uh, Uh, Xu, Mm, Hh, Hh^Ftp, Gs^Ftp, Ww, Wot, Ww, Hh^Ftp, Mm, Xu, Xu, Xu, Xu, Xu, Xu, Xu, Xu, Xu, Xu, Xu, Xu, Xu, Xu, Xu, Xu, Xu, Xu, Xu, Uu, Xu, Xu, Xu, Xu, Xu, Xu, Xu, Xu, Xu, Uu, Uu, Uu, Xu, Xu, Uu, Ur, Uu, Xu
Uu, Ur, Uu, Ur, Ur, Ce, Ur, Uh, Uu, Uu, Uu, Xu, Uh, Xu, Mm, Mm, Hh^Ftp, Hh^Ftp, Gs^Ftp, Ww, Wwt, Ww, Hh^Ftp, Mm, Xu, Uu, Uu, Uu, Uu, Uu, Uu, Uu, Uu, Uu, Uu, Uu, Uu, Uu, Uu, Uu, Uu, Uu, Uu, Uu^Tf, Uu, Uu, Uu, Xu, Uu, Uh, Uu, Uu, Uu, Xu, Xu, Xu, Xu, Uu, Uu, Ur^Vu, Uu, Xu
Xu, Uu, Uu, Uh, Ur, Uu^Tf, Ur, Ur, Ur, Uu, Ur^Vdt, Uu, Uu, Xu, Mm, Hh^Ftp, Gs^Ftp, Gs^Ftp, Ww, Ww, Wwt, Ww, Hh^Ftp, Mm, Xu, Uu, Dd, Dd, Dd^Es, Dd^Es, Dd^Es, Uu, Dd, Dd^Es, Dd, Dd^Es, Dd, Dd^Es, Dd, Dd^Es, Dd, Dd^Es, Dd, Dd^Es, Dd^Es, Uu^Vu, Dd^Es, Uu, Uu, Uu, Xu, Uu, Uu, Xu, Uu, Uu, Uu, Uu, Xu, Uu, Xu, Xu
Xu, Uu, Uu, Uu, Ur, Ur, Uu, Uu, Uu, Ur, Uu, Uu, Uu, Xu, Mm, Hh^Ftp, Gs^Ftp, Gs^Es, Ww, Wot, Wwt, Hh^Ftp, Hh^Ftp, Xu, Xu, Uu, Ds, Ds^Es, Ds, Dd^Vdt, Ds, Dd^Es, Ds, Ds^Es, Ds, Ds^Es, Ds, Ds^Es, Ds, Ds, Ds, Ds, Ds, Ds, Ds, Dd^Es, Ds, Dd^Es, Uu, Xu, Xu, Uu^Vu, Xu, Uu, Xu, Uu, Xu, Xu, Xu, Xu, Xu, Xu
Xu, Uu, Uu, Ur^Vdt, Ur, Uu, Xu, Xu, Uu, Ur, Ww^Bw\, Ww, Ss, Xu, Mm, Hh, Gs^Vht, Gs^Es, Ww, Wot, Wwt, Hh^Ftp, Dd, Xu, Xu, Ds, Wwt, Ds, Wwt, Ds, Wwt, Ds, Wwt, Ds, Wwt, Wwt, Wwt, Wwt, Wwt, Wwt, Wwt, Wwt, Wwt, Wwt, Wwt, Ds, Wwt, Ds^Es, Uu, Xu, Xu, Xu, Xu, Xu, Xu, Xu, Xu, Xu, Uu, Xu, Uu, Xu
Xu, Xu, Uu, Uu, Ur, Uu, Uu, Uu^Ecf, Uu, Ww^Bw\, Ww, Ww, Ss, Xu, Mm, Hh^Ftp, Gs^Ftp, Gs, Gs, Ww, Wot, Ww, Ww, Xu, Xu, Ds, Wwt, Wwt, Wwt, Wwt, Wwt, Wwt, Wwt, Wwt, Wwt, Wwt, Wwt, Wwt, Wot, Wwt, Wot, Wwt, Wwt, Wwt, Wwt, Wwt, Wwt, Ds, Ds, Uu^Tf, Uu, Uu, Uu, Xu, Uu, Xu, Uu, Uu, Uu, Uu^Vu, Uu, Uu
Xu, Uh, Uu, Uu, Uu, Ur, Ur, Uu, Uu, Ww, Ss, Ww, Ww, Ss, Ss, Hh^Ftp, Gs^Ftp, Gs^Ftp, Ww, Ww, Wwt, Ww, Hh^Ftp, Xu, Xu, Ds, Ds, Ds, Wwt, Wwt, Ds, Ds, Ds, Ds, Ds, Ds, Wwt, Wwt, Wwt, Wot, Wot, Wwt, Uue, Uue, Uue, Wwt, Wot, Wwt, Ds, Ds, Ds, Dd, Ds^Es, Uu, Ds, Uu, Ds, Ds, Ds, Ds, Ds, Uu
Xu, Uh, Uu, Uu^Ecf, Uu, Uu, Uu, Ur, Ur^Vdt, Uu, Uu, Ss, Ss, Ww, Ww, Ss, Ww, Gs, Ww, Wot, Wwt, Gs^Ftp, Hh^Ftp, Xu, Xu, Uu, Dd, Ds^Es, Ds, Wwt, Wwt, Ds, Ds^Es, Ds^Es, Ds, Ds, Ds, Wwt, Wwt, Wot, Wwt, Wwt, Ww, Uue, Uue, Wwt, Wot, Wwt, Wwt, Wwt, Wwt, Ds^Es, Wwt, Ds, Wwt, Ds, Wwt, Wwt, Wwt, Wwt, Wwt, Ds
Xu, Uh, Uh, Uu, Uh, Uu, Uu, Uu, Uu, Uu, Uu, Uu, Xu, Ss, Ss, Ww, Ww, Ww, Wwt, Wot, Wwt, Gs^Ftp, Hh^Vht, Mm, Xu, Uu, Uu, Dd^Es, Dd^Es, Ds, Ds^Vda, Ds^Es, Ds^Es, Ds, Ds, Ds, Ds, Wwt, Wwt, Wwt, Wwt, Wwt, Wwt, Uue, Wwt, Wwt, Wwt, Wwt, Wwt, Wwt, Ds, Wwt, Ds, Wwt, Wwt, Wwt, Ds, Ds, Ds, Ds, Ds, Wwt
Md, Xu, Xu, Xu, Xu, Xu, Xu, Uu, Uh, Uu, Xu, Xu, Md, Mm, Hd, Ds^Es, Ds, Ww, Wwt, Wot, Wwt, Ww, Hh, Mm, Xu, Xu, Xu, Uu, Uu, Ce, Ce, Ds^Es, Ds^Es, Ds^Es, Ds, Ds^Es, Ds^Es, Ds, Ds^Es, Ds, Wwt, Wot, Wwt, Wwt, Wwt, Ds, Ds, Ds, Ds, Ds, Dd^Es, Ds, Dd, Ds, Dd, Ds^Es, Uu, Uu, Uu, Uu, Uu, Ds
Md, Md, Md, Md, Md, Md, Md, Xu, Xu, Xu, Md, Md, Mm, Mm, Hh^Ftp, Ds^Es, Gs, Ww, Wwt, Wwt, Wwt, Hh, Hhd, Md, Md, Md, Md, Xu, Xu, Xu, Ke, Ce, Ce, Dd, Dd, Dd^Vda, Ds, Ds^Es, Ds^Es, Ds, Ds, Wwt, Ds, Ds, Ds, Ds, Uu, Uu, Uu, Dd^Es, Uu, Dd^Es, Uu, Uu, Uu, Uu, Xu, Xu, Xu, Xu, Xu, Uu
Hhd, Md, Md, Hhd, Hhd, Mm, Mm, Md, Md, Md, Mm, Mm, Hhd, Hh^Ftp, Hh, Gs, Ww, Ww, Wot, Wwt, Ww, Gs, Hhd^Ftp, Hhd, Hhd, Hhd, Md, Xu, Xu, Re, Xu, Xu, Uu, Dd, Dd^Es, Dd, Dd^Es, Dd^Es, Dd, Dd, Dd, Ds, Dd, Dd^Vdt, Dd, Uu, Uh, Uh, Uh, Uu, Uh, Uu, Uh, Uh, Uh, Uh, Uh, Uh, Uh, Xu, Xu, Xu
Md, Hhd, Hhd, Hhd, Gd, Hhd, Hhd, Mm, Mm, Mm, Mm, Hhd, Gd^Vht, Gs, Gs, Gs, Ww, Wwt, Wwt, Ww, Gs, Gd^Ftp, Gd^Ftp, Hhd^Ftp, Gd, Hhd, Md, Md, Md, Xu, Xu, Xu, Xu, Uu, Uu, Uu, Uu, Uu, Uu, Dd^Es, Uu, Dd^Es, Uu^Tf, Dd^Es, Uu, Uu, Uh, Qxu^Xo, Qxu, Uh, Uh, Uh, Qxu, Qxu, Qxu, Qxu, Qxu, Uh, Uh, Uh, Uh, Xu
Hhd, Hhd, Hhd, Gd, Gd, Hhd, Gd, Hhd, Hhd, Mm, Hhd^Es, Hhd, Gd, Gs, Ww, Ww, Wwt, Wot, Wwt, Ww, Gs, Gd, Ce, Gd, Gd, Hhd, Hhd^Ftp, Md, Md, Md, Md, Xu, Xu, Uu, Uu, Uu, Uu, Uu, Uu, Uu, Uu, Uu, Uu, Uu, Uu, Uh, Uh, Qxu, Qxu^Xo, Qxu, Uh, Uh, Qxu, Qxu, Qxu, Qxu, Qxu, Uh, Qxu, Uh, Uh^Vhcr, Uh
Hhd, Gd, Gd, Gd^Es, Hhd, Gd, Gd^Es, Gd, Gd, Hhd, Gd^Es, Gd, Gd, Ww, Wwt, Wwt, Wot, Wwt, Ww, Ww, Gs, Ce, 4 Ke, Ce, Gd, Gd, Gd^Ftp, Hhd^Ftp, Hhd^Ftp, Hhd^Vd, Hhd^Es, Md, Md, Xu, Xu, Xu, Xu, Xu, Xu, Xu, Xu, Xu, Uu, Uu, Uu, Uh, Uh, Qxu, Qxu, Qxu, Uh, Uh, Uh, Qxu, Uh, Qxu, Uh, Qxu, Uh, Uh, Uh, Uh
Gd, Gd, Gd, Gd, Hhd^Vd, Hhd, Gd^Es, Gd, Gd, Gd, Gd, Gd, Ww, Ww, Wwt, Wot, Wwt, Wwt, Ww, Gs, Gd, Ce, Ce, Ce, Gd, Gd, Hhd^Es, Hhd, Gd, Hhd, Gd, Hhd, Hhd, Md, Md, Md, Md, Md, Md, Xu, Xu, Xu, Xu, Xu, Xu, Xu, Xu, Uh, Uh, Uh, Uh, Uh, Uh, Uh, Uh, Uh, Uh, Uh, Uh, Uh, Uh, Uh
Gs, Gd, Gd, Gd^Es, Gd, Gd^Es, Gs, Gs, Gs^Ftp, Gs, Gs, Gs, Ww, Wwt, Wot, Wot, Wwt, Ww, Gs, Gs, Gs, Gd, Gd, Gd, Hhd, Gd, Gd, Gd^Es, Gd, Gd, Gd, Gd, Gd, Hhd^Ftp, Hhd, Hhd, Hhd, Hhd, Hhd^Ftp, Md, Md, Md, Md, Md, Md, Md, Xu, Xu, Xu, Xu, Xu, Xu, Xu, Xu, Xu, Xu, Xu, Xu, Xu, Xu, Xu, Xu
Gs^Ftp, Gs, Gs, Gs, Gs, Gs^Es, Gs, Gs^Ftp, Gs, Gs^Ftp, Gs, Ww, Wwt, Wwt, Wot, Wo, Ww, Ww, Gs, Gs^Ftp, Gs, Gs^Vc, Gs, Gd, Gd^Ftp, Hhd, Gd^Es, Gd, Gd, Dd, Dd, Dd, Gd, Gd, Gd, Gd, Gd, Gd^Ftp, Hhd^Ftp, Hhd^Ftp, Hhd, Md, Hhd^Vd, Md, Hhd, Md, Md, Md, Md, Md, Md, Md, Md, Md, Xu, Xu, Xu, Xu, Xu, Xu, Xu, Xu
Gs, Gs^Ftp, Gs^Ftp, Gs^Ftp, Gs, Gs, Ww, Gs, Ww, Gs, Ww, Ww, Wwt, Wot, Wwt, Wwt, Ww, Gs, Gs^Ftp, Gs^Ftp, Gs, Gs, Gs, Gd, Gd^Es, Hhd^Es, Hd, Dd, Dd, Dd, Dd^Es, Dd, Dd, Dd^Es, Dd, Gd, Gd^Es, Gd, Gd, Hhd^Es, Gd^Es, Hhd, Hhd, Hhd, Gd, Hhd, Hhd, Hhd, Hhd, Hhd^Ftp, Hhd^Ftp, Md, Md, Md, Md, Md, Md, Md, Md, Md, Md, Md
Gs, Gs^Ftp, Gs, Gs, Ww, Gs, Ww, Ww, Wwt, Ww, Wwt, Wwt, Wot, Wot, Wwt, Ww, Gs, Gs, Gs, Gs^Ftp, Gs, Hh, Gd, Gd, Gd, Dd, Hd, Hd, Dd^Es, Dd^Es, Dd, Dd^Es, Dd, Dd, Dd, Gd, Gd, Gd, Gd, Gd, Gd^Es, Gd^Es, Gd, Gd, Dd^Es, Dd^Es, Gd, Gd, Gd, Gd^Ftp, Gd, Hhd, Hhd^Ftp, Hhd^Ftp, Hhd, Hhd^Ftp, Hhd, Hhd, Hhd^Ftp, Hhd^Ftp, Hhd^Ftp, Hhd
Gs, Gs, Gs, Gs, Ww, Ww, Wwt, Wwt, Wot, Wwt, Wwt, Wot, Wot, Wwt, Wwt, Ww, Ww, Gs, Gs^Ftp, Gs, Gs, Hh, Hhd, Gd, Dd, Dd^Es, Dd^Es, Dd, Dd^Es, Dd^Es, Dd^Vdt, Dd^Es, Dd, Dd^Es, Dd, Dd, Gd, Gd, Gd^Ftp, Gd, Gd, Gd, Gd, Gd, Gd, Dd, Gd, Gd^Es, Gd, Gd, Gd, Gd^Ftp, Gd^Ftp, Gd^Ftp, Gd, Gd^Ftp, Gd, Hhd, Gd, Gd^Ftp, Gd^Ftp, Gd
Gs, Ww, Ww, Ww, Wwt, Wwt, Wot, Wwt, Wot, Wot, Wot, Wot, Wot, Wot, Wwt, Ww, Gs, Gs, Gs^Ftp, Gs^Ftp, Gs, Hh, Hhd, Gd, Gd, Dd, Dd^Es, Dd^Es, Dd, Dd, Dd^Es, Dd, Dd, Dd^Es, Dd, Gd, Gd, Gd, Gd^Ftp, Gd^Ftp, Gd, Gd, Gd^Es, Hhd, Hhd^Es, Gd, Gd, Gd, Gd, 1 Gd, Gd, Gd, Gd, Gd, Gd, Gd, Hhd, Gd, Hhd, Gd^Ftp, Gd, Gd
Ww, Ww, Wwt, Wwt, Wot, Wwt, Wot, Wot, Wot, Wot, Wot, Wot, Wot, Wot, Wwt, Ww, Ww, Gs, Gs, Gs, Gs, Gs, Gs, Gd, Dd, Dd, Dd, Dd, Dd, Dd^Es, Dd, Dd^Es, Dd^Es, Dd^Es, Dd, Dd, Gd, Gd^Ftp, Gd, Gd^Ftp, Gd, Gd, Gd, Gd^Es, Gd^Es, Gd, Gd^Es, Gd, Gd, Gd^Es, Gd, Gd, Gd, Gd, Gd, Hhd, Gd, Hhd^Vd, Hhd, Gd, Hhd, Gd
Wwt, Wwt, Wwt^Vm, Wot, Wot, Wot, Wot, Wot, Wot, Wot, Wot, Wot, Wot, Wot, Wot, Wwt, Ww, Gs, Ss, Gs, Gs, Gs, Gs, Gd, Gd, Gd, Gd, Gd, Dd, Dd, Dd, Dd, Dd, Dd^Es, Dd, Dd, Dd, Gd, Gd^Es, Gd, Gd, Dd, Gd, Gd, Gd, Gd, Gd, Gd, Gd, Gd, Hhd, Hhd, Gd, Gd, Gd, Gd, Gd^Ftp, Gd, Hhd, Hhd, Hhd, Gd
Wot, Wwt, Wot, Wot, Wot, Wot, Wot, Wot, Wot, Wot, Wot, Wot, Wot, Wot, Wot, Wwt, Wwt, Ww, Ww^Vm, Ss, Gs, Gs^Ftp, Gs^Ftp, Gs, Gd, Hhd, Gd, Gd, Gd, Gd, Gd^Es, Gd^Es, Gd^Es, Dd, Gd, Gd, Gd, Gd, Gd, Gd, Gd, Gd, Gd, Gd, Gd^Ftp, Gd, Gd, Hhd, Hhd, Gd, Gd, Hhd, Gd, Gd, Gd^Ftp, Gd^Ftp, Gd^Ftp, Gd, Gd, Hhd, Gd, Gd
Wot, Wot, Wot, Wot, Wot, Wot, Wot, Wot, Wot, Wot, Wot, Wot, Wot, Wot, Wot, Wot, Wwt, Wwt, Wwt, Ww, Ww, Gs, Gs, Gs, Gs, Gd, Gd^Ftp, Gd, Gd, Gd, Gd, Gd, Gd, Gd, Hhd, Hhd, Gd, Gd, Hhd^Vd, Hhd, Hhd, Hhd, Gd, Gd, Gd^Ftp, Gd^Ftp, Gd, Hhd, Gd, Gd, Gd, Gd, Gd, Gd, Gd, Gd^Ftp, Gd^Ftp, Gd, Gd, Gd, Dd^Es, Dd
Wot, Wot, Wot, Wot, Wot, Wot, Wot, Wot, Wot, Wot, Wot, Wot, Wot, Wot, Wot, Wot, Wot, Wwt, Wwt, Ww, Ww, Gs, Gs, Gs^Ftp, Gs, Gd, Gd, Gd^Ftp, Gd, Gd, Gd, Gd^Ftp, Gd, Gd, Gd, Gd, Gd, Gd, Gd, Gd, Gd, Hhd, Gd, Gd, Gd, Gd^Ftp, Gd, Gd, Gd, Gd, Gd, Gd, Gd, Gd, Gd, Gd^Ftp, Gd, Gd, Gd, Dd, Dd^Es, Dd
