Mm, Mm, Mm, Mm, Mm, Mm, Mm, Mm, Mm, Mm, Mm, Mm, Hh^Ftp, Hh^Ftp, Hh^Ftp, Gs^Ftp, Gs, Wot, Wot, Wwt, Hh^Ftp, Gd, Hh, Hh, Hh^Fms, Gd^Fms, Hh^Fms, Gs^Qhu, Gs^Qhu, Gd^Qhu, Gd^Qhu, Gd^Qhu, Hhd, Hhd, Hhd, Hhd, Md, Hhd, Hhd, Hhd, Hhd, Md, Md, Hhd, Hhd, Hhd, Md, Md, Hhd, Uh^Qhh, Uh^Qhh, Uh, Uh, Xu, Xu, Xu, Xu, Xu, Xu, Xu, Xu, Xu^Qhh
Mm, Mm, Mm, Mm, Mm, Mm, Mm, Hh^Fms, Mm, Mm, Mm, Mm, Mm, Hh^Ftp, Hh^Vht, Gs^Ftp, Gs, Wwt, Wwt, Wwt, Ww, Hh^Ftp, Mm, Mm, Mm, Hh, Hh^Fms, Gs^Fds, Hh^Fds, Gs^Qhu, Gs^Qhu, Gd^Qhu, Hhd, Hhd, Hhd, Hhd, Hhd, Hhd, Md, Hhd, Hhd, Md, Hhd^Fmf, Hhd^Fmf, Hhd^Fmf, Md, Md, Hhd, Uh^Qhh, Uh^Qhh, Uh, Uh, Uh^Qhh, Uh, Uh^Qhh, Uh^Qhh, Uh^Qhh, Uh, Uh, Xu, Xu^Qhh, Xu^Qhh
Mm, Mm, Mm, Mm, Mm, Mm, Mm, Hh^Fms, Mm, Mm, Hh, Mm, Mm, Mm, Mm, Hh^Ftp, Hh^Ftp, Gs^Es, Gs^Es, Wwt, Ww, Hh^Ftp, Hh^Ftp, Mm, Mm, Mm, Mm, Hh, Mm, Hh^Fds, Gs^Fds, Gd^Qhu, Gd^Qhu, Hhd, Gd^Qhu, Hhd, Hhd, Hhd, Hhd, Md, Hhd, Hhd, Md, Ce^Fmf, Md, Md, Hhd, Hhd, Uh^Qhh, Uh^Vd, Uh^Qhh, Uh^Qhh, Ql, Ce^Qhh, Ql, Ql, Uh^Qhh, Uh^Qhh, Uh^Qhh, Uh^_mh, Uh, Uh^Qhh
Mm, Mm, Hh^Fms, Hh^Fms, Hh^Fds, Hh^Vd, Mm, Mm, Md, Hh, Md, Hh, Md, Hh, Hh^Fds, Hh, Hh, Hh^Ftp, Gs^Ftp, Wwt, Wwt, Ww, Hh^Ftp, Hh^Ftp, Hh^Ftp, Mm, Mm, Mm, Mm, Hh^Fms, Hh^Fds, Gs^Qhu, Gs^Qhu, Gd^Qhu, Gd^Qhu, Gd^Qhu, Hhd, Hhd, Hhd, Md, Hhd, Md, Md, Hhd, Md, Md, Hhd, Uh^Qhh, Ch, Uh, Uh^Qhh, Ql, Ql, Ql, Ql, Ql, Ql, Ql, Uh^Qhh, Uh^Qhh, Uh^Qhh, Uh^Qhh
Hh^Fms, Mm, Mm, Mm, Mm, Hh, Mm, Md, Md, Md, Md, Md, Md, Md, Md, Md, Md, Hh, Hh, Gs, Wwt, Ww, Ww, Gs^Ftp, Gs^Ftp, Hh^Vht, Mm, Mm, Mm, Hh^Fms, Hh^Fms, Gs^Fms, Gs^Fms, Gs^Qhu, Gd^Qhu, Gd^Qhu, Hhd, Hhd^Vd, Hhd, Hhd, Hhd, Hhd, Hhd, Hhd, Md, Md, Hhd, Ch^Qhh, Kh, Ce, Uh^Qhh, Ql, Ql, Ql, Ql, Ql, Ql, Ql, Ql, Ql, Ql, Ql
Hh^Fms, Hh^Fms, Md, Mm, Mm, Mm, Xu^Qhh, Xu^Qhh, Xu^Qhh, Xu^Qhh, Xu^Qhh, Xu^Qhh, Xu^Qhh, Xu^Qhh, Xu^Qhh, Md, Mm, Hh, Hh^Ftp, Gs^Ftp, Gs, Wwt, Ww, Gs^Ftp, Gs^Ftp, Hh^Ftp, Mm, Mm, Mm, Mm, Mm, Hh^Fms, Gs^Fms, Gs^Qhu, Gs^Qhu, Gd^Qhu, Gd^Qhu, Hhd, Hhd^Es, Hhd^Es, Hhd, Md, Hhd, Md, Hhd, Md, Hhd, Ch^Qhh, Ce, Ce, Uh^Qhh, Uh^Qhh, Ql, Ql, Ql, Ql, Ql, Ql, Ql, Ql, Ql, Ql
Md, Md, Md, Md, Uu^Qhh, Uu^Qhh, Uu, Uu, Uu, Uu, Uu, Uu^Qhu, Uu^Qhu, Uu^Qhu, Uu, Xu^Qhh, Mm, Mm, Hh^Ftp, Hh^Ftp, Gs, Wwt, Wwt, Ww, Gs, Hh^Ftp, Mm, Mm, Mm, Mm, Hh, Hh^Fms, Hh^Fms, Gs^Fds, Gs^Qhu, Gs^Qhu, Gd^Qhu, Hhd, Hhd, Hhd, Md, Hhd, Hhd, Hhd, Hhd, Md, Hhd, Uh^Qhh, Uh^Qhh, Uh, Uh^Qhh, Ql, Ql, Ql, Ql, Ql, Ql, Ql, Ql, Ql, Ql, Ql
Md, Md, Xu^Qhh, Xu^Qhh, Uu, Uu, Uu^Tf, Uu, Uu, Uu, Ur, Ur^Vdt, Ur, Uu^Qhu, Ur, Uu^Qhh, Hh, Mm, Hh, Hh, Gs^Ftp, Gs, Wwt, Ww, Gs^Es, Hh^Ftp, Mm, Mm, Mm, Mm, Mm, Mm, Mm, Hh^Fms, Gs^Fms, Gs^Qhu, Gd^Qhu, Hhd, Hhd^Fmf, Hhd^Fmf, Hhd^Fmf, Hhd, Md, Ce, Md, Md, Md, Hhd, Uh^Qhh, Uh, Uh, Uh^Qhh, Uh^Qhh, Ce^Qhh, Uh^Qhh, Ql, Ql, Ql, Ql, Ql, Uh^Qhh, Uh^Qhh
Xu^Qhh, Xu^Qhh, Uh, Uu, Uh, Uu, Uu, Uu, Ur, Ur, Uu, Ur, Ur^Vdt, Ur, Uu, Ur^Qhh, Re, Re, Re, Re, Re, Gs, Wwt, Ww, Gs^Es, Hh, Mm, Mm, Mm, Mm, Mm, Mm, Mm, Hh^Fms, Hh^Fms, Gs^Qhu, Gd^Qhu, Gd^Qhu, Hhd, Hhd^Fmf, Hhd, Hhd, Hhd, Hhd, Hhd^Fmf, Hhd, Md, Hhd, Uh^Qhh, Uh, Uh, Uh, Uh, Uh^Qhh, Ql, Ql, Ql, Ql, Ql, Ql, Uh^Qhh, Uh^Qhh
Xu^Qhh, Xuc, Uh, Uu, Uu, Uu, Uu, Uu, Ce, Uu, Uu, Uu, Uu, Uu, Uu, Uu^Qhh, Mm, Hh, Hh^Ftp, Hh, Gs, Ww^Bw\, Ww^Bw\, Ww, Gs, Hh, Hh, Mm, Hh^Vc, Mm, Mm, Mm, Mm, Mm, Hh^Fms, Gs^Fds, Gs^Qhu, Gd^Qhu, Hhd, Md, Hhd, Hhd, Hhd, Hhd^Fmf, Hhd^Fmf, Hhd^Fmf, Hhd, Hhd, Ce, Uh^Qhh, Uh^Qhh, Uh^Vd, Uh, Uh^Qhh, Uh^Qhh, Uh^Qhh, Uh^Qhh, Uh^Qhh, Uh^Qhh, Uh^Qhh, Uh, Uh^Qhh
Xu^Qhh, Xuc, Uh^Qhu, Uu, Uu^Ecf, Uu, Uu, Ce, 3 Ke, Ce, Uu, Uh, Uu^Ecf, Uu, Uu, Xu^Qhh, Mm, Mm, Hh^Ftp, Gs, Ww, Wwt, Ww, Re, Re, Hh, Hh, Hh, Hh, Hh, Hh, Mm, Hh, Mm, Hh^Fms, Gs^Fms, Gs^Qhu, Gd^Qhu, Gd^Qhu, Hhd, Hhd, Md, Hhd^Vd, Md, Md, Hhd, Hhd, Md, Hhd, Hhd, Hhd, Uh^Qhh, Uh^Qhh, Uh, Uh, Uh^_mh, Uh, Uh^Qhh, Uh^Qhh, Uh^_mh, Xu^Qhh, Uh^Qhh
Xu^Qhh, Uh^Qhu, Uu^Qhu, Uu, Uu, Uu, Uu, Ce, Ce, Ce, Uu, Uu, Uu, Uu, Uu^_mh, Xu^Qhh, Mm, Hh^Ftp, Hh^Ftp, Gs, Ww, Wot, Ww, Gs, Gs^Ftp, Hh, Mm, Hh, Hh, Hh, Hh, Hh, Mm, Mm, Mm, Hh^Fms, Hh^Fms, Gs^Qhu, Gd^Qhu, Hhd, Hhd, Hhd, Hhd, Hhd, Md, Hhd, Hhd, Md, Md, Md, Hhd, Hhd, Hhd, Uh^Qhh, Xu^Qhh, Xu^Qhh, Xu^Qhh, Xu^Qhh, Xu, Xu^Qhh, Xu, Xu^Qhh
Xu^Qhh, Uu^Qhu, Ur^Vdt, Uu, Uu, Xu, Uu, Uu, Ur, Uu, Uu, Xu, Uu, Uu, Uu, Xu^Qhh, Mm, Hh^Ftp, Gs^Ftp, Gs, Ww, Wwt, Ww, Gs^Ftp, Hh^Ftp, Hh, Mm, Mm, Mm, Mm, Mm, Hh, Hh, Mm, Hh, Mm, Hh, Gs^Qhu, Gs^Qhu, Gd^Qhu, Hhd, Md, Hhd, Hhd, Hhd, Md, Hhd^Fmf, Hhd, Hhd, Md, Hhd, Md, Md, Hhd, Xu, Xu, Xu, Xu, Xu, Xu, Xu, Xu
Xu^Qhh, Uu^Qhu, Uu^Qhh, Ur^Qhh, Ur^Qhh, Uu, Ur, Ur, Uu^Qhh, Ur, Ur, Uu, Ur, Ur^Vdt, Uu, Xu^Qhh, Mm, Hh^Ftp, Gs^Ftp, Ww, Wwt, Wot, Ww, Gs^Ftp, Hh^Ftp, Hh, Mm, Mm, Mm, Mm, Mm, Mm, Mm, Mm, Hh^Fms, Hh, Hh^Fms, Hh^Fms, Hhd, Gd^Qhu, Hhd, Hhd, Hhd, Hhd, Hhd, Hhd^Fmf, Hhd^Fmf, Md, Md, Hhd, Hhd, Hhd, Hhd, Md, Xu, Xu, Uh, Xu, Uu, Uh, Xu, Xu
Xu^Qhh, Xu^Qhh, Uu, Uu, Uu, Ur^Qhh, Uu^Qhh, Uu^Qhh, Uh^Qhh, Uu^Qhh, Uu^Qhh, Ur, Uu^Qhh, Uu, Uh, Xu^Qhh, Mm, Hh^Ftp, Gs, Ww, Wot, Ww, Gs^Vht, Gs^Ftp, Hh, Hh, Mm, Mm, Mm, Mm, Mm, Mm, Mm, Mm, Mm, Mm, Mm, Mm, Md, Md, Md, Md, Md, Hhd, Md, Md, Md, Md, Md, Hhd, Md, Md, Hhd, Md, Xu, Xu, Uu, Uu, Ur, Uu, Tb^Tf, Xu
Uu, Uu, Uu, Uu, Ce, Ce, Ce, Uu, Uu, Uu^Tf, Uu, Uu^Qhh, Uh, Xu^Qhh, Xu^Qhh, Xu^Qhh, Mm, Hh^Ftp, Gs, Ww, Wot, Ww, Hh^Ftp, Hh, Mm, Mm, Xu, Xu, Xu, Xu, Xu, Xu, Xu, Xu, Xu, Xu, Xu, Xu, Xu, Xu, Xu, Xu, Uu, Ur, Uu, Xu, Xu, Xu, Xu, Xu, Xu, Xu, Uu, Xu, Xu, Xu, Uu^Qhu, Uu, Uu, Ur, Uu, Xu
Ur, Uu^Ecf, Ur, Ur, Ce, 2 Ke, Ce, Uu, Uu, Uu^Ecf, Uu, Xu, Uh, Uh, Xu, Mm, Hh, Hh^Ftp, Gs^Ftp, Ww, Wot, Ww, Hh^Ftp, Mm, Xu, Xu, Xu, Xu, Xu, Xu, Xu, Xu, Xu, Xu, Xu, Xu, Xu, Xu, Xu, Xu, Xu, Xu, Xu, Uu, Xu, Xu, Xu, Xu, Xu, Xu, Xu, Xu, Xu, Uu, Uu^Qhu, Uu^Qhu, Xu, Xu, Uu, Ur, Uu, Xu
Uu, Ur, Uu, Ur, Ur, Ce, Ur, Uh, Uu^Qhu, Uu^Qhu, Uu, Xu, Uh, Xu, Mm, Mm, Hh^Ftp, Hh^Ftp, Gs^Ftp, Ww, Wwt, Ww, Hh^Ftp, Mm, Xu, Uu, Uu, Uu, Uu, Uu, Uu, Uu, Uu, Uu, Uu, Uu, Uu, Uu, Uu, Uu, Uu, Uu, Tb^Tf, Tb^Tf, Uu, Uu, Uu, Xu, Uu, Uh, Uu, Uu^Qhh, Uu^Qhh, Xu, Xu, Xu, Xu, Uu, Uu, Ur^Vu, Tb^Tf, Xu
Xu, Uu, Uu^Qhu, Uh, Ur, Uu^Tf, Ur, Ur, Ur, Uu, Ur^Vdt, Uu, Uu, Xu, Mm, Hh^Ftp, Gs^Ftp, Gs^Ftp, Ww, Ww, Wwt, Ww, Hh^Ftp, Mm, Xu, Uu, Ds, Dd, Ds^Es, Dd, Dd^Es, Uu, Dd, Dd, Dd, Dd, Dd, Dd^Es, Dd, Dd^Es, Dd, Dd^Es, Dd, Dd^Es, Dd^Es, Uu^Vct, Dd^Es, Uu, Uu, Xu, Xu, Uu^Es, Uu, Xu, Uu, Uu^Qhh, Uu^Qhh, Uu^Qhh, Xu, Uu, Xu, Xu
Xu, Uu^Qhu, Uu^Qhu, Uu, Ur, Ur, Uu, Uu, Uu, Ur, Uu, Uu, Uu, Xu, Mm, Hh^Ftp, Gs^Ftp, Gs^Es, Ww, Wot, Wwt, Hh^Ftp, Hh^Ftp, Xu, Xu, Uu, Ds, Ds^Es, Ds, Dd^Vct, Ds, Dd, Ds, Ds^Es, Ds, Ds^Es, Ds, Ds^Es, Ds, Ds, Ds, Ds, Ds, Ds^Es, Ds^Es, Dd^Es, Ds, Dd^Es, Uu, Xu, Xu, Uu^Vu, Xu, Uu, Xu, Uu^Qhh, Xu, Xu, Xu, Xu, Xu, Xu
Xu, Uu^Qhu, Uu, Ur^Vdt, Ur, Uu, Xu, Xu, Uu, Ur, Ww^Bw\, Ww, Ss, Xu, Mm, Hh, Gs^Vht, Gs^Es, Ww, Wot, Wwt, Hh^Ftp, Dd, Xu, Xu, Ds, Wwt, Ds, Wwt, Ds, Wwt, Ds, Wwt, Ds, Wwt, Wwt, Wwt, Wwt, Wwt, Wwt, Wwt, Wwt, Wwt, Wwt, Wwt, Ds, Wwt, Ds, Uu, Xu, Xu, Xu, Xu, Xu, Xu, Xu, Xu, Xu, Tb^Tf, Xu, Uu, Xu
Xu, Xu, Uu, Uu, Ur, Uu, Uu, Uu^Ecf, Uu, Ww^Bw\, Ww, Ww, Ss, Xu, Mm, Hh^Ftp, Gs^Ftp, Gs, Gs, Ww, Wot, Ww, Ww, Xu, Xu, Ds, Wwt, Wwt, Wwt, Wwt, Wwt, Wwt, Wwt, Wwt, Wwt, Wwt, Wwt, Wwt, Wot, Wwt, Wot, Wwt, Wwt, Wwt, Wwt, Wwt, Wwt, Ds, Ds, Tb^Tf, Tb^Tf, Uu, Uu, Xu, Uu, Xu, Uu, Tb^Tf, Tb^Tf, Uu, Uu, Uu
Xu, Uh, Uu, Uu, Uu, Ur, Ur, Uu, Uu, Ww, Ss, Ww, Ww, Ss, Ss, Hh^Ftp, Gs^Ftp, Gs^Ftp, Ww, Ww, Wwt, Ww, Hh^Ftp, Xu, Xu, Ds, Ds, Ds, Wwt, Wwt, Ds, Ds, Ds, Ds, Ds, Ds, Wwt, Wwt, Wwt, Wot, Wot, Wwt, Uue^Qhh, Uue^Qhh, Uue^Qhh, Wwt, Wot, Wwt, Ds, Ds, Ds, Dd, Ds^Es, Uu, Ds, Uu, Ds, Ds, Ds, Ds, Ds, Uu
Xu, Uh, Uu, Uu^Ecf, Uu, Uu^Qhu, Uu^Qhu, Ur, Ur^Vdt, Uu, Uu, Ss, Ss, Ww, Ww, Ss, Ww, Gs, Ww, Wot, Wwt, Gs^Ftp, Hh^Ftp, Xu, Xu, Uu^Qhh, Dd^Es, Ds, Ds, Wwt, Wwt, Ds, Ds^Es, Ds^Es, Ds^Vct, Ds, Ds, Wwt^Bw/r, Wwt, Wot, Wwt, Wwt, Ww, Uue^Qhh, Uue^Qhh, Wwt, Wot, Wwt, Wwt, Wwt, Wwt, Ds^Es, Wwt, Ds, Wwt, Ds, Wwt, Wwt, Wwt, Wwt, Wwt, Ds
Xu, Uh, Uh, Uu, Uh, Uu^Qhu, Uu^Qhu, Uu^Qhu, Uu^Qhu, Uu, Uu^Qhu, Uu, Xu, Ss, Ss, Ww, Ww, Ww, Wwt, Wot, Wwt, Gs^Ftp, Hh^Vht, Mm, Xu, Uu^Qhh, Uu^Qhh, Dd^Es, Dd^Es, Ds, Ds^Vct, Ds, Ds^Es, Ds, Ds, Ds, Ds, Wwt, Wwt, Wwt, Wwt, Wwt, Wwt, Uue^Qhh, Wwt, Wwt, Wwt, Wwt, Wwt, Wwt, Ds, Wwt, Ds, Wwt, Wwt, Wwt, Ds, Ds, Ds, Ds, Ds, Wwt
Md, Xu, Xu, Xu, Xu, Xu, Xu, Uu^Qhu, Uh^Qhu, Uu^Qhu, Xu, Xu, Md, Mm, Hd, Ds^Es, Ds, Ww, Wwt, Wot, Wwt, Ww, Hh, Mm, Xu, Xu, Xu, Uu^Qhh, Uu^Qhh, Cer, Cer, Cer, Cer, Ds^Es, Ds, Ds^Es, Ds^Es, Ds, Ds^Es, Ds, Wwt, Wot, Wwt, Wwt, Wwt, Ds, Ds, Ds, Ds, Ds, Dd^Es, Ds, Dd, Ds, Ds^Es, Ds, Tb^Tf, Tb^Tf, Tb^Tf, Uu, Uu, Ds
Md, Md, Md, Md, Md, Md, Md, Xu, Xu, Xu, Md, Md, Mm, Mm, Hh^Ftp, Ds^Es, Gs, Ww, Wwt, Wwt, Wwt, Hh, Hhd, Md, Md, Md, Md, Xu, Xu, Xu, Ker, Cer, Cer, Dd, Ds, Ds^Vct, Ds^Es, Ds^Es, Ds^Es, Ds, Ds, Wwt, Ds, Ds, Ds, Ds, Uu, Uu, Uu, Dd^Es, Uu, Dd^Es, Uu, Uu, Uu, Uu, Xu, Xu, Xu, Xu, Xu, Uu
Hhd, Md, Md, Hhd, Hhd, Mm, Mm, Md, Md, Md, Mm, Mm, Hhd, Hh^Ftp, Hh, Gs, Ww, Ww, Wot, Wwt, Ww, Gs, Hhd^Ftp, Hhd, Hhd, Hhd, Md, Xu, Xu, Re, Xu, Xu, Uu^Qhh, Dd, Dd, Dd^Es, Dd^Es, Dd, Dd, Ds, Dd^Es, Ds, Dd, Dd^Vct, Dd^Es, Uu, Uh^Qhh, Uh^Qhh, Uh^Qhh, Uu, Uh^Qhh, Uu, Uh^Qhh, Uh^Qhh, Uh^Qhh, Uh^Qhh, Uh, Uh^Qhh, Uh^Qhh, Xu, Xu, Xu
Md, Hhd, Hhd, Hhd, Gd, Hhd, Hhd, Mm, Mm, Mm, Mm, Hhd, Gd^Vht, Gs, Gs, Gs, Ww, Wwt, Wwt, Ww, Gs, Gd^Ftp, Gd^Ftp, Hhd^Ftp, Gd, Hhd, Md, Md, Md, Xu, Xu, Xu, Xu, Uu^Qhh, Uu^Qhh, Uu, Uu^Qhh, Uu^Qhh, Uu^Qhh, Dd^Es, Uu^Qhh, Dd^Es, Tb^Tf, Dd^Es, Uu, Uu, Uh^Qhh, Qxu, Qxu, Uh^Qhh, Uh^Qhh, Uh^Qhh, Qxu, Qxu, Qxu, Qxu, Qxu, Uh^Qhh, Uh^Qhh, Uh^Qhh, Uh^Qhh, Xu
Hhd, Hhd, Hhd, Gd, Gd, Hhd, Gd, Hhd, Hhd, Mm, Hhd^Es, Hhd, Gd, Gs, Ww, Ww, Wwt, Wot, Wwt, Ww, Gs, Gd, Ce, Gd, Gd, Hhd, Hhd^Ftp, Md, Md, Md, Md, Xu, Xu, Uu^Qhh, Uu^Qhh, Uu^Qhh, Uu^Qhh, Uu^Qhh, Uu^Qhh, Uu^Qhh, Uu^Qhh, Uu^Qhh, Tb^Tf, Uu, Uu, Uh^Qhh, Uh^Qhh, Qxu, Qxu, Qxu, Uh^Qhh, Uh^Qhh, Qxu, Qxu, Qxu, Qxu, Qxu, Uh^Qhh, Qxu, Uh^Qhh, Uh^Vhcr, Uu^Qhh
Hhd, Gd, Gd, Gd^Es, Hhd, Gd, Gd^Es, Gd, Gd, Hhd, Gd^Es, Gd, Gd, Ww, Wwt, Wwt, Wot, Wwt, Ww, Ww^Bw\, Gs, Ce, 4 Ke, Ce, Gd, Gd, Gd^Ftp, Hhd^Ftp, Hhd^Ftp, Hhd^Vd, Hhd^Es, Md, Md, Xu, Xu, Xu, Xu, Xu, Xu, Xu, Xu, Xu, Tb^Tf, Tb^Tf, Tb^Tf, Uh^Qhh, Uh^Qhh, Qxu, Qxu, Qxu, Uh^Qhh, Uh^Qhh, Uh^Qhh, Qxu, Uh^Qhh, Qxu, Uh^Qhh, Qxu, Uh^Qhh, Uh^Qhh, Uh^_mh, Uh^Qhh
Gd, Gd, Gd, Gd, Hhd^Vd, Hhd, Gd^Es, Gd, Gd, Gd, Gd, Gd, Ww, Ww, Wwt, Wot, Wwt, Wwt, Ww, Gs, Gd, Ce, Ce, Ce, Gd, Gd, Hhd^Es, Hhd, Gd, Hhd, Gd, Hhd, Hhd, Md, Md, Md, Md, Md, Md, Xu, Xu, Xu, Xu, Xu, Xu, Xu^Qhh, Xu^Qhh, Uh^Qhh, Uh^Qhh, Uu^Qhh, Uh^Qhh, Uh^Qhh, Uh^Qhh, Uh^Qhh, Uh^Qhh, Uh^Qhh, Uh^Qhh, Uh^Qhh, Uh^Qhh, Uh^Qhh, Uh, Uu
Gs, Gd, Gd, Gd^Es, Gd, Gd^Es, Gs, Gs, Gs^Ftp, Gs, Gs, Gs, Ww, Wwt, Wot, Wot, Wwt, Ww, Gs, Gs, Gs, Gd, Gd, Gd, Hhd, Gd, Gd, Gd^Es, Gd, Gd, Gd, Gd, Gd, Hhd^Ftp, Hhd, Hhd, Hhd, Hhd, Hhd^Ftp, Md, Md, Md, Md, Md, Md, Md, Xu, Xu^Qhh, Xu^Qhh, Xu^Qhh, Xu^Qhh, Xu^Qhh, Xu^Qhh, Xu^Qhh, Xu^Qhh, Xu^Qhh, Xu^Qhh, Xu^Qhh, Xu^Qhh, Xu^Qhh, Xu^Qhh, Xu^Qhh
Gs^Ftp, Gs, Gs, Gs, Gs, Gs^Es, Gs, Gs^Ftp, Gs, Gs^Ftp, Gs, Ww, Wwt, Wwt, Wot, Wo, Ww, Ww, Gs, Gs^Ftp, Gs, Gs^Vc, Gs, Gd, Gd^Ftp, Hhd, Gd^Es, Gd, Gd, Dd^Qhu, Dd^Qhu, Dd^Qhu, Gd, Gd, Gd, Gd, Gd, Gd^Ftp, Hhd^Ftp, Hhd^Ftp, Hhd, Md, Hhd^Vd, Md, Hhd, Md, Md, Md, Md, Md, Md, Md, Md, Md, Xu, Xu, Xu, Xu, Xu, Xu, Xu, Xu
Gs, Gs^Ftp, Gs^Ftp, Gs^Ftp, Gs, Gs, Ww, Gs, Ww, Gs, Ww, Ww, Wwt, Wot, Wwt, Wwt, Ww, Gs, Gs^Ftp, Gs^Ftp, Gs, Gs, Gs, Gd, Gd^Es, Hhd^Es, Hd^Qhu, Dd^Qhu, Dd^Qhu, Dd^Qhu, Dd^Es, Dd^Qhu, Dd^Qhu, Dd^Qhu, Dd^Qhu, Gd, Gd^Es, Gd, Gd, Hhd^Es, Gd^Es, Hhd, Hhd, Hhd, Gd, Hhd, Hhd, Hhd, Hhd, Hhd^Ftp, Hhd^Ftp, Md, Md, Md, Md, Md, Md, Md, Md, Md, Md, Md
Gs, Gs^Ftp, Gs, Gs, Ww, Gs, Ww, Ww, Wwt, Ww, Wwt, Wwt, Wot, Wot, Wwt, Ww, Gs, Gs, Gs, Gs^Ftp, Gs, Hh, Gd, Gd, Gd, Dd^Qhu, Hd, Hd, Dd^Es, Dd^Es, Dd, Dd^Es, Dd, Dd, Dd^Qhu, Gd, Gd, Gd, Gd, Gd, Gd^Es, Gd^Es, Gd, Gd, Dd^Es, Dd^Es, Gd, Gd, Gd, Gd^Ftp, Gd, Hhd, Hhd^Ftp, Hhd^Ftp, Hhd, Hhd^Ftp, Hhd, Hhd, Hhd^Ftp, Hhd^Ftp, Hhd^Ftp, Hhd
Gs, Gs, Gs, Gs, Ww, Ww, Wwt, Wwt, Wot, Wwt, Wwt, Wot, Wot, Wwt, Wwt, Ww, Ww, Gs, Gs^Ftp, Gs, Gs, Hh, Hhd, Gd, Dd^Qhu, Dd^Qhu, Dd^Es, Dd, Dd^Es, Dd^Es, Dd^Vdt, Dd^Es, Dd, Dd^Es, Dd^Qhu, Dd^Qhu, Gd, Gd, Gd^Ftp, Gd, Gd, Gd, Gd, Gd, Gd, Dd, Gd, Gd^Es, Gd, Gd, Gd, Gd^Ftp, Gd^Ftp, Gd^Ftp, Gd, Gd^Ftp, Gd, Hhd, Gd, Gd^Ftp, Gd^Ftp, Gd
Gs, Ww, Ww, Ww, Wwt, Wwt, Wot, Wwt, Wot, Wot, Wot, Wot, Wot, Wot, Wwt, Ww, Gs, Gs, Gs^Ftp, Gs^Ftp, Gs, Hh, Hhd, Gd, Gd, Dd^Qhu, Dd^Es, Dd^Es, Dd, Dd^_ml, Dd^Es, Dd, Dd, Dd^Es, Dd^Qhu, Gd, Gd, Gd, Gd^Ftp, Gd^Ftp, Gd, Gd, Gd^Es, Hhd, Hhd^Es, Gd, Gd, Gd, Gd, 1 Gd, Gd, Gd, Gd, Gd, Gd, Gd, Hhd, Gd, Hhd, Gd^Ftp, Gd, Gd
Ww, Ww, Wwt, Wwt, Wot, Wwt, Wot, Wot, Wot, Wot, Wot, Wot, Wot, Wot, Wwt, Ww, Ww, Gs, Gs, Gs, Gs, Gs, Gs, Gd, Dd^Qhu, Dd^Qhu, Dd^Qhu, Dd^Qhu, Dd^Qhu, Dd^Es, Dd, Dd^Es, Dd^Es, Dd^Es, Dd, Dd^Qhu, Gd, Gd^Ftp, Gd, Gd^Ftp, Gd, Gd, Gd, Gd^Es, Gd^Es, Gd, Gd^Es, Gd, Gd, Gd^Es, Gd, Gd, Gd, Gd, Gd, Hhd, Gd, Hhd^Vd, Hhd, Gd, Hhd, Gd
Wwt, Wwt, Wwt^Vm, Wot, Wot, Wot, Wot, Wot, Wot, Wot, Wot, Wot, Wot, Wot, Wot, Wwt, Ww, Gs, Ss, Gs, Gs, Gs, Gs, Gd, Gd, Gd, Gd, Gd, Dd^Qhu, Dd^Qhu, Dd^Qhu, Dd^Qhu, Dd^Qhu, Dd^Es, Dd^Qhu, Dd^Qhu, Dd^Qhu, Gd, Gd^Es, Gd, Gd, Dd, Gd, Gd, Gd, Gd, Gd, Gd, Gd, Gd, Hhd, Hhd, Gd, Gd, Gd, Gd, Gd^Ftp, Gd, Hhd, Hhd, Hhd, Gd
Wot, Wwt, Wot, Wot, Wot, Wot, Wot, Wot, Wot, Wot, Wot, Wot, Wot, Wot, Wot, Wwt, Wwt, Ww, Ww^Vm, Ss, Gs, Gs^Ftp, Gs^Ftp, Gs, Gd, Hhd, Gd, Gd, Gd, Gd, Gd^Es, Gd^Es, Gd^Es, Dd^Qhu, Gd, Gd, Gd, Gd, Gd, Gd, Gd, Gd, Gd, Gd, Gd^Ftp, Gd, Gd, Hhd, Hhd, Gd, Gd, Hhd, Gd, Gd, Gd^Ftp, Gd^Ftp, Gd^Ftp, Gd, Gd, Hhd, Gd, Gd
Wot, Wot, Wot, Wot, Wot, Wot, Wot, Wot, Wot, Wot, Wot, Wot, Wot, Wot, Wot, Wot, Wwt, Wwt, Wwt, Ww, Ww, Gs, Gs, Gs, Gs, Gd, Gd^Ftp, Gd, Gd, Gd, Gd, Gd, Gd, Gd, Hhd, Hhd, Gd, Gd, Hhd^Vd, Hhd, Hhd, Hhd, Gd, Gd, Gd^Ftp, Gd^Ftp, Gd, Hhd, Gd, Gd, Gd, Gd, Gd, Gd, Gd, Gd^Ftp, Gd^Ftp, Gd, Gd, Gd, Dd^Es, Dd
Wot, Wot, Wot, Wot, Wot, Wot, Wot, Wot, Wot, Wot, Wot, Wot, Wot, Wot, Wot, Wot, Wot, Wwt, Wwt, Ww, Ww, Gs, Gs, Gs^Ftp, Gs, Gd, Gd, Gd^Ftp, Gd, Gd, Gd, Gd^Ftp, Gd, Gd, Gd, Gd, Gd, Gd, Gd, Gd, Gd, Hhd, Gd, Gd, Gd, Gd^Ftp, Gd, Gd, Gd, Gd, Gd, Gd, Gd, Gd, Gd, Gd^Ftp, Gd, Gd, Gd, Dd, Dd^Es, Dd
